Địa phương,Năm,Trường,Lớp,Học sinh,Học sinh nữ,Học sinh dân tộc thiểu số,Giáo viên,Giáo viên nữ,Giáo viên dân tộc thiểu số,Học sinh nam,Giáo viên nam
An Giang,2004,138,3207,128010,60702,5667,5140,2925,37,67308,2215
An Giang,2005,142,3660,123396,59249,6013,5434,3038,59,64147,2396
An Giang,2006,147,3152,117918,52897,5560,5893,3248,58,65021,2645
An Giang,2007,149,3025,110991,59076,5127,6330,3486,34,51915,2844
An Giang,2008,152,3183,109428,54620,4937,6455,3621,76,54808,2834
An Giang,2009,154,2950,104860,50689,4503,6711,3707,72,54171,3004
An Giang,2010,155,3047,102852,51426,4941,6796,3867,86,51426,2929
An Giang,2011,155,3091,104691,52271,5177,6737,3813,96,52420,2924
An Giang,2012,154,3113,106962,53279,5732,6833,3882,105,53683,2951
An Giang,2013,155,3189,111028,54955,5986,7048,4037,103,56073,3011
An Giang,2014,156,3273,113789,56320,6038,7038,4012,110,57469,3026
An Giang,2015,156,3356,114935,56933,5966,6951,3929,106,58002,3022
An Giang,2016,156,3371,118338,58890,5883,6868,3885,117,59448,2983
An Giang,2017,156,3441,122497,60691,6068,6847,3872,123,61806,2975
An Giang,2018,156,3470,96304,61528,6224,6696,3829,130,34776,2867
An Giang,2019,155,3483,128147,63156,6372,6671,3786,136,64991,2885
An Giang,2020,154,3518,130961,64454,6600,6621,3752,136,66507,2869
An Giang,2021,151,3486,125895,61675,6807,6648,3773,150,64220,2875
Bà Rịa - Vũng Tàu,2004,69,1765,72113,35325,1066,3040,2224,0,36788,816
Bà Rịa - Vũng Tàu,2005,70,1831,72031,35571,1137,3236,2284,0,36460,952
Bà Rịa - Vũng Tàu,2006,70,1901,72598,35882,1456,3304,2354,0,36716,950
Bà Rịa - Vũng Tàu,2007,71,1865,71375,34806,1334,3410,2466,0,36569,944
Bà Rịa - Vũng Tàu,2008,73,1875,67850,33356,1515,3510,2628,0,34494,882
Bà Rịa - Vũng Tàu,2009,74,1861,63697,31348,1463,3538,2658,0,32349,880
Bà Rịa - Vũng Tàu,2010,76,1860,61076,29953,1448,3538,2668,0,31123,870
Bà Rịa - Vũng Tàu,2011,78,1870,61827,30337,1476,3508,2648,0,31490,860
Bà Rịa - Vũng Tàu,2012,82,1915,61827,30047,1612,3548,2687,0,31780,861
Bà Rịa - Vũng Tàu,2013,85,1965,63634,30907,1603,3614,2738,0,32727,876
Bà Rịa - Vũng Tàu,2014,85,2035,66679,32757,1555,3612,2758,0,33922,854
Bà Rịa - Vũng Tàu,2015,87,2072,66989,32856,1645,3743,2866,0,34133,877
Bà Rịa - Vũng Tàu,2016,87,2107,68220,33553,1666,3702,2840,0,34667,862
Bà Rịa - Vũng Tàu,2017,88,2108,69807,34088,1687,3697,2829,26,35719,868
Bà Rịa - Vũng Tàu,2018,88,2061,69747,33956,1859,3069,2850,30,35791,219
Bà Rịa - Vũng Tàu,2019,88,2039,72730,35303,1721,3697,2870,33,37427,827
Bà Rịa - Vũng Tàu,2020,89,2071,76207,37006,2060,3618,2823,35,39201,795
Bà Rịa - Vũng Tàu,2021,90,2105,75882,36793,2151,3737,2927,44,39089,810
Bình Dương,2004,43,1357,55243,26848,0,2422,1715,0,28395,707
Bình Dương,2005,48,1352,54860,27063,0,2467,1812,0,27797,655
Bình Dương,2006,49,1384,55721,27451,404,2533,1866,0,28270,667
Bình Dương,2007,51,1379,54235,26797,359,2546,2270,0,27438,276
Bình Dương,2008,53,1372,52937,25927,359,2711,1993,0,27010,718
Bình Dương,2009,54,1376,51105,24914,348,2808,2092,0,26191,716
Bình Dương,2010,57,1383,50707,24693,345,2825,2114,0,26014,711
Bình Dương,2011,64,1479,55040,26421,453,2896,2158,0,28619,738
Bình Dương,2012,66,1561,57782,27770,800,3255,2411,0,30012,844
Bình Dương,2013,66,1715,64297,30583,900,3413,2231,0,33714,1182
Bình Dương,2014,68,1922,71619,34385,990,3756,2854,0,37234,902
Bình Dương,2015,69,2062,76040,36529,1098,3902,2960,0,39511,942
Bình Dương,2016,71,2249,85230,41037,1193,4210,3172,0,44193,1038
Bình Dương,2017,72,2435,93600,45300,1425,4590,3464,0,48300,1126
Bình Dương,2018,74,2546,101138,48944,2326,4461,3417,0,52194,1044
Bình Dương,2019,75,2779,111764,54042,2801,4447,3370,0,57722,1077
Bình Dương,2020,77,2971,121953,59151,3228,4554,3442,0,62802,1112
Bình Dương,2021,79,3082,123185,59582,3530,4582,3475,0,63603,1107
Bình Phước,2004,84,1662,63779,30929,7523,2316,1438,32,32850,878
Bình Phước,2005,84,1658,63063,30738,8925,2772,1588,25,32325,1184
Bình Phước,2006,86,1681,58901,28797,8543,2778,1815,38,30104,963
Bình Phước,2007,88,1679,60898,29505,10727,3137,2050,51,31393,1087
Bình Phước,2008,88,1646,58348,28647,9435,3316,2143,66,29701,1173
Bình Phước,2009,88,1640,56084,28191,9814,2809,1919,56,27893,890
Bình Phước,2010,90,1651,54914,27385,9886,3363,2257,61,27529,1106
Bình Phước,2011,93,1704,56765,27890,10272,3288,2204,86,28875,1084
Bình Phước,2012,96,1576,51883,25615,7931,2838,1874,112,26268,964
Bình Phước,2013,96,1983,60068,29672,10755,3530,2410,133,30396,1120
Bình Phước,2014,99,1881,61406,30255,10617,3571,2437,141,31151,1134
Bình Phước,2015,99,1858,61266,30270,11114,3600,2468,143,30996,1132
Bình Phước,2016,99,1866,61603,30476,11272,3646,2495,142,31127,1151
Bình Phước,2017,101,1868,63730,31428,11759,3536,2437,132,32302,1099
Bình Phước,2018,90,1906,65946,32386,12201,3708,2488,160,33560,1220
Bình Phước,2019,78,1901,67804,33260,12284,3715,2538,187,34544,1177
Bình Phước,2020,67,1921,70407,34500,12267,3715,2529,186,35907,1186
Bình Phước,2021,66,1891,68450,33354,11612,3557,2445,182,35096,1112
Bình Thuận,2004,101,2488,101315,50277,5515,3796,2528,74,51038,1268
Bình Thuận,2005,108,2575,101764,50941,5932,4165,2765,85,50823,1400
Bình Thuận,2006,115,2568,101691,51286,5776,4362,2893,98,50405,1469
Bình Thuận,2007,117,2475,95660,48909,6137,4651,3095,122,46751,1556
Bình Thuận,2008,117,2464,90889,46618,6027,4715,3135,117,44271,1580
Bình Thuận,2009,121,2445,84870,43249,5949,4799,3226,119,41621,1573
Bình Thuận,2010,123,2381,79236,40108,6234,4803,3210,128,39128,1593
Bình Thuận,2011,124,2379,78098,38889,6189,4761,3197,124,39209,1564
Bình Thuận,2012,123,2369,76732,38318,6192,4772,3197,119,38414,1575
Bình Thuận,2013,127,2406,76498,38424,6175,4813,3220,148,38074,1593
Bình Thuận,2014,128,2446,76465,38694,6104,4783,3205,155,37771,1578
Bình Thuận,2015,126,2445,75474,38182,6077,4766,3182,163,37292,1584
Bình Thuận,2016,127,2266,75791,38419,6149,4696,3147,167,37372,1549
Bình Thuận,2017,127,2304,77214,38929,6055,4569,3049,161,38285,1520
Bình Thuận,2018,121,2300,77559,39065,6289,4041,2988,169,38494,1053
Bình Thuận,2019,115,2280,78653,39100,6444,4387,2927,177,39553,1460
Bình Thuận,2020,113,2305,80849,40147,6647,4340,2902,187,40702,1438
Bình Thuận,2021,113,2268,78289,38874,6730,4270,2864,190,39415,1406
Bình Định,2004,117,3310,143101,68368,2471,4736,2494,0,74733,2242
Bình Định,2005,117,3278,142570,68993,2838,4945,2733,0,73577,2212
Bình Định,2006,127,3258,137177,44774,2792,4972,2872,0,92403,2100
Bình Định,2007,128,3108,129628,63401,3041,5256,3016,0,66227,2240
Bình Định,2008,130,3018,120924,58958,2709,5354,3075,0,61966,2279
Bình Định,2009,140,2905,112057,54520,2789,5341,3120,0,57537,2221
Bình Định,2010,140,2787,104364,51118,2537,5287,3078,0,53246,2209
Bình Định,2011,141,2712,100709,49521,2577,5262,3070,0,51188,2192
Bình Định,2012,142,2650,97037,47630,2271,5267,3117,0,49407,2150
Bình Định,2013,144,2624,95027,46706,2197,5284,3041,39,48321,2243
Bình Định,2014,145,2659,94762,46777,2345,5174,3042,39,47985,2132
Bình Định,2015,146,3216,93423,45907,2457,5163,3069,38,47516,2094
Bình Định,2016,146,2674,92653,45452,2538,5087,3051,35,47201,2036
Bình Định,2017,145,2691,93943,46134,2719,5018,3026,35,47809,1992
Bình Định,2018,144,2655,94580,46304,2843,4988,2948,38,48276,2040
Bình Định,2019,143,2667,94836,46342,2882,4700,2871,40,48494,1829
Bình Định,2020,141,2688,96568,47149,3005,4630,2863,40,49419,1767
Bình Định,2021,141,2601,91717,44640,3017,4560,2863,39,47077,1697
Bạc Liêu,2004,67,1344,54355,24572,3566,2214,1133,83,29783,1081
Bạc Liêu,2005,67,1287,51098,23827,3605,2441,1218,73,27271,1223
Bạc Liêu,2006,66,1234,48346,22581,3432,2688,1330,81,25765,1358
Bạc Liêu,2007,66,1257,44715,19581,2982,2366,1243,94,25134,1123
Bạc Liêu,2008,67,1082,41204,19727,2883,2262,1162,109,21477,1100
Bạc Liêu,2009,68,1039,38376,18441,2653,2175,1138,73,19935,1037
Bạc Liêu,2010,69,1020,37572,18183,2586,2210,1165,75,19389,1045
Bạc Liêu,2011,67,1045,40092,19529,2801,2205,1150,84,20563,1055
Bạc Liêu,2012,66,1099,43091,21016,3433,2249,1178,92,22075,1071
Bạc Liêu,2013,62,1156,46330,22474,3739,2272,1199,89,23856,1073
Bạc Liêu,2014,61,1210,48574,23778,3959,2251,1217,101,24796,1034
Bạc Liêu,2015,60,1218,48918,23941,3989,2309,1262,96,24977,1047
Bạc Liêu,2016,62,1222,48513,23643,4348,2323,1257,95,24870,1066
Bạc Liêu,2017,63,1221,47907,23433,4488,2355,1284,100,24474,1071
Bạc Liêu,2018,61,1204,69663,22458,4294,2324,1258,116,47205,1066
Bạc Liêu,2019,59,1186,45975,22282,4260,2270,1232,131,23693,1038
Bạc Liêu,2020,59,1209,46939,22803,4400,2257,1219,122,24136,1038
Bạc Liêu,2021,59,1184,44772,22018,4247,2229,1211,121,22754,1018
Bắc Giang,2004,219,3742,150124,71676,21164,6854,4826,254,78448,2028
Bắc Giang,2005,220,3556,134509,65175,22018,6843,4658,312,69334,2185
Bắc Giang,2006,221,3460,129435,64494,21122,6901,4697,321,64941,2204
Bắc Giang,2007,226,4165,118223,56624,20346,6945,4600,351,61599,2345
Bắc Giang,2008,220,3198,107455,49240,16205,6495,4272,347,58215,2223
Bắc Giang,2009,226,3259,103043,48417,15775,6433,4350,339,54626,2083
Bắc Giang,2010,227,3160,96081,47367,16095,6695,4519,445,48714,2176
Bắc Giang,2011,225,3138,95489,46914,16087,6577,4373,470,48575,2204
Bắc Giang,2012,225,3148,95070,46495,16521,6735,4553,496,48575,2182
Bắc Giang,2013,225,3125,93769,45640,16350,6710,4522,546,48129,2188
Bắc Giang,2014,225,3112,95041,46118,15893,6540,4425,531,48923,2115
Bắc Giang,2015,225,3095,94134,45390,16424,6395,4333,541,48744,2062
Bắc Giang,2016,225,3075,94076,45149,15512,6321,4266,560,48927,2055
Bắc Giang,2017,215,3074,95787,45733,15291,6381,4368,612,50054,2013
Bắc Giang,2018,214,3040,98828,46898,15410,6245,4292,616,51930,1953
Bắc Giang,2019,212,3042,102528,48333,15547,6062,4216,621,54195,1846
Bắc Giang,2020,209,3018,108311,50632,16768,6012,4201,644,57679,1811
Bắc Giang,2021,209,3104,114021,53092,18710,6022,4231,682,60929,1791
Bắc Kạn,2004,74,808,26932,12908,23978,1450,1063,1090,14024,387
Bắc Kạn,2005,76,798,25341,12019,22588,1476,1062,1126,13322,414
Bắc Kạn,2006,74,757,24428,11586,21588,1476,1062,1126,12842,414
Bắc Kạn,2007,74,744,22136,11510,19563,1497,1056,1138,10626,441
Bắc Kạn,2008,74,692,19593,9992,15478,1424,1015,1214,9601,409
Bắc Kạn,2009,74,665,18308,9050,15612,1467,1071,1185,9258,396
Bắc Kạn,2010,77,649,16911,8192,15494,1461,1076,1122,8719,385
Bắc Kạn,2011,80,616,15903,7723,14498,1306,965,1204,8180,341
Bắc Kạn,2012,80,617,16041,7770,14705,1313,970,1287,8271,343
Bắc Kạn,2013,80,603,15925,7635,14582,1321,981,1061,8290,340
Bắc Kạn,2014,80,612,16422,7908,14990,1349,1004,1074,8514,345
Bắc Kạn,2015,80,629,17002,8158,15576,1339,987,1094,8844,352
Bắc Kạn,2016,76,622,16968,8084,15529,1361,1005,1117,8884,356
Bắc Kạn,2017,61,631,17349,8325,15834,1343,985,1115,9024,358
Bắc Kạn,2018,59,634,17768,8560,16273,1183,941,1048,9208,242
Bắc Kạn,2019,57,628,17956,8665,16406,1218,897,980,9291,321
Bắc Kạn,2020,59,631,18779,9161,17235,1182,877,973,9618,305
Bắc Kạn,2021,56,641,19718,9641,18215,1143,848,941,10077,295
Bắc Ninh,2004,132,2124,88042,42296,0,3830,2736,0,45746,1094
Bắc Ninh,2005,133,2086,82701,40321,0,3866,2737,0,42380,1129
Bắc Ninh,2006,133,2021,78106,37828,0,3887,2764,0,40278,1123
Bắc Ninh,2007,136,1952,73753,35529,0,4058,2885,0,38224,1173
Bắc Ninh,2008,134,1916,69208,33551,0,3756,2738,0,35657,1018
Bắc Ninh,2009,134,1889,66314,32056,0,3873,2799,0,34258,1074
Bắc Ninh,2010,134,1872,63672,30947,0,3847,2747,0,32725,1100
Bắc Ninh,2011,134,1871,63145,31377,0,3802,2788,0,31768,1014
Bắc Ninh,2012,134,1863,62779,30300,0,3886,2698,0,32479,1188
Bắc Ninh,2013,134,1870,62554,29915,0,3818,2744,0,32639,1074
Bắc Ninh,2014,135,1890,64376,32556,0,3885,2771,0,31820,1114
Bắc Ninh,2015,135,1905,64783,30904,0,4126,3203,0,33879,923
Bắc Ninh,2016,135,1934,66570,31758,0,4165,3261,0,34812,904
Bắc Ninh,2017,135,1980,68790,32410,0,4125,3207,0,36380,918
Bắc Ninh,2018,134,1986,71871,33675,158,3961,3208,0,38196,753
Bắc Ninh,2019,134,2035,75970,34993,207,3981,3208,0,40977,773
Bắc Ninh,2020,134,2119,80369,36136,217,3962,3193,0,44233,769
Bắc Ninh,2021,134,2172,83513,37672,355,4064,3304,0,45841,760
Bến Tre,2004,133,2488,93854,46080,0,3916,2504,0,47774,1412
Bến Tre,2005,135,2365,89483,43996,0,4451,2781,0,45487,1670
Bến Tre,2006,135,2329,87365,43072,0,4514,2868,0,44293,1646
Bến Tre,2007,137,2232,82185,40785,0,4492,2882,0,41400,1610
Bến Tre,2008,137,2188,78036,39061,0,4428,2806,0,38975,1622
Bến Tre,2009,135,2074,72139,36019,0,4383,2768,0,36120,1615
Bến Tre,2010,137,2023,68656,34321,0,4344,2732,0,34335,1612
Bến Tre,2011,136,2029,69647,34279,0,4302,2686,0,35368,1616
Bến Tre,2012,136,2023,68556,33915,0,4451,2727,0,34641,1724
Bến Tre,2013,134,2053,71283,35360,0,4270,2654,0,35923,1616
Bến Tre,2014,132,2091,74032,36965,0,4247,2623,0,37067,1624
Bến Tre,2015,133,2088,73634,36813,0,4241,2606,0,36821,1635
Bến Tre,2016,133,2059,73327,36581,0,4210,2573,0,36746,1637
Bến Tre,2017,132,2053,72975,36304,0,4112,2502,0,36671,1610
Bến Tre,2018,132,2019,55297,34874,150,4280,2458,0,20423,1822
Bến Tre,2019,131,1995,70197,34883,181,3993,2415,0,35314,1578
Bến Tre,2020,130,1980,71708,35614,206,3882,2343,0,36094,1539
Bến Tre,2021,128,1919,68596,33844,214,3745,2244,0,34752,1501
Cao Bằng,2004,72,1353,45772,22196,43983,2024,1629,1777,23576,395
Cao Bằng,2005,88,1384,42961,20893,41695,2181,1729,1951,22068,452
Cao Bằng,2006,94,1310,40211,19474,38956,2443,1886,2196,20737,557
Cao Bằng,2007,100,1281,35385,16853,33008,2508,1938,2215,18532,570
Cao Bằng,2008,107,1237,34057,16555,33023,2521,1909,2192,17502,612
Cao Bằng,2009,116,1210,31287,15348,30583,2682,2079,2413,15939,603
Cao Bằng,2010,121,1210,30277,14416,29053,2768,2095,2468,15861,673
Cao Bằng,2011,153,1188,29785,14136,28663,2577,1898,2412,15649,679
Cao Bằng,2012,156,1173,28507,13746,27523,2601,1959,2357,14761,642
Cao Bằng,2013,157,1160,28263,13551,27536,2582,1926,2304,14712,656
Cao Bằng,2014,160,1146,28259,13587,27467,2549,1917,2311,14672,632
Cao Bằng,2015,160,1146,29069,14014,28252,2507,1893,2270,15055,614
Cao Bằng,2016,161,1209,29019,13937,28167,2504,1896,2235,15082,608
Cao Bằng,2017,162,1157,29837,14374,28911,2441,1826,2223,15463,615
Cao Bằng,2018,131,1144,30097,14635,29133,2333,1733,2124,15462,600
Cao Bằng,2019,100,1139,30097,14598,29067,2239,1640,2024,15499,599
Cao Bằng,2020,99,1138,31069,15082,30011,2184,1598,1981,15987,586
Cao Bằng,2021,98,1163,32054,15529,30931,2116,1545,1924,16525,571
Cà Mau,2004,99,2011,81869,37498,1693,3857,2044,0,44371,1813
Cà Mau,2005,102,1965,76894,34428,1392,3738,2013,0,42466,1725
Cà Mau,2006,105,1916,72971,31612,1507,3740,2141,0,41359,1599
Cà Mau,2007,107,1877,65884,30314,1376,3963,2261,0,35570,1702
Cà Mau,2008,107,1762,61513,27066,1353,4119,2347,0,34447,1772
Cà Mau,2009,106,1684,57288,26866,1299,4122,2350,0,30422,1772
Cà Mau,2010,109,1681,55807,26665,1283,3948,2173,0,29142,1775
Cà Mau,2011,111,1733,59074,28534,1199,3855,2161,0,30540,1694
Cà Mau,2012,117,1782,62336,30050,1304,3839,2181,0,32286,1658
Cà Mau,2013,117,1869,67490,32406,1422,3925,2213,0,35084,1712
Cà Mau,2014,118,2044,72975,35505,1584,3929,2233,0,37470,1696
Cà Mau,2015,118,2018,74095,36164,1653,3990,2277,0,37931,1713
Cà Mau,2016,120,2041,73091,35624,1607,4019,2298,0,37467,1721
Cà Mau,2017,120,1959,71922,35094,1647,3889,2225,35,36828,1664
Cà Mau,2018,116,1784,62386,34059,1829,3653,2138,42,28327,1515
Cà Mau,2019,113,1816,69408,33673,1996,3563,2052,49,35735,1511
Cà Mau,2020,109,1851,70159,34216,2134,3563,2048,49,35943,1515
Cà Mau,2021,105,1839,65864,31944,1965,3544,2043,47,33920,1501
Cần Thơ,2004,54,1674,66342,32656,1407,2611,1713,0,33686,898
Cần Thơ,2005,55,1645,64994,31598,1509,2996,1938,0,33396,1058
Cần Thơ,2006,55,1671,62957,31267,1617,3070,1999,0,31690,1071
Cần Thơ,2007,55,1539,59404,29879,1134,3094,2053,0,29525,1041
Cần Thơ,2008,56,1524,57545,28967,1256,3111,2122,0,28578,989
Cần Thơ,2009,62,1497,55025,27379,1128,3170,2166,0,27646,1004
Cần Thơ,2010,62,1468,53678,26851,1182,3205,2185,0,26827,1020
Cần Thơ,2011,62,1516,55447,27643,1300,3144,2140,0,27804,1004
Cần Thơ,2012,64,1522,56215,27368,1032,3315,2182,0,28847,1133
Cần Thơ,2013,65,1551,59429,29272,1154,3234,2158,0,30157,1076
Cần Thơ,2014,64,1625,62088,30757,1672,3357,2240,0,31331,1117
Cần Thơ,2015,63,1645,62906,31118,1778,3379,2264,0,31788,1115
Cần Thơ,2016,63,1694,64368,31746,1713,3440,2301,0,32622,1139
Cần Thơ,2017,66,1741,66562,32901,1928,3453,2306,43,33661,1147
Cần Thơ,2018,67,1754,45031,32927,1992,3315,2270,49,12104,1045
Cần Thơ,2019,68,1801,69160,33189,2060,3325,2234,55,35971,1091
Cần Thơ,2020,69,1856,71975,35382,2115,3319,2233,57,36593,1086
Cần Thơ,2021,69,1838,68422,33660,1985,3328,2238,61,34762,1090
Gia Lai,2004,110,2461,86810,41256,24791,3729,2406,181,45554,1323
Gia Lai,2005,118,2558,88774,42782,26854,4154,2666,193,45992,1488
Gia Lai,2006,134,2622,93266,44546,29957,4496,2891,237,48720,1605
Gia Lai,2007,147,2640,92306,45442,29809,4590,2964,253,46864,1626
Gia Lai,2008,155,2628,90853,45377,30933,4696,3013,259,45476,1683
Gia Lai,2009,170,2725,88005,43317,31396,4879,3247,284,44688,1632
Gia Lai,2010,178,2577,87093,43882,20982,5036,3349,302,43211,1687
Gia Lai,2011,188,2615,89081,45224,34032,4996,3363,322,43857,1633
Gia Lai,2012,197,2589,89839,45577,34337,5170,3402,341,44262,1768
Gia Lai,2013,203,2624,93043,47730,37585,5262,3563,385,45313,1699
Gia Lai,2014,204,2644,94788,48905,38106,5174,3509,370,45883,1665
Gia Lai,2015,208,2641,94752,49054,38650,5210,3522,392,45698,1688
Gia Lai,2016,209,2663,96253,50119,39836,5087,3474,398,46134,1613
Gia Lai,2017,210,2681,98567,51493,41114,5024,3428,404,47074,1596
Gia Lai,2018,190,2610,99907,52052,41800,4752,3302,408,47855,1450
Gia Lai,2019,171,2640,102325,53174,42929,4649,3175,412,49151,1474
Gia Lai,2020,163,2692,106262,54894,44609,4543,3106,387,51368,1437
Gia Lai,2021,162,2692,105890,54477,45539,4501,3100,409,51413,1401
Hà Giang,2004,68,1370,42875,19728,35587,2505,1506,868,23147,999
Hà Giang,2005,89,1564,47069,22815,38618,2856,1746,1129,24254,1110
Hà Giang,2006,110,1695,49778,22715,40820,3059,1915,1064,27063,1144
Hà Giang,2007,116,1788,49395,22555,41904,3434,2171,1207,26840,1263
Hà Giang,2008,128,1744,48249,21952,42282,3505,2122,1287,26297,1383
Hà Giang,2009,147,1767,48051,21855,42797,3677,2342,1405,26196,1335
Hà Giang,2010,156,1788,47375,21508,41230,3795,2375,1596,25867,1420
Hà Giang,2011,161,1789,47539,21138,41029,3611,2223,1622,26401,1388
Hà Giang,2012,165,1809,47671,21764,42191,3909,2431,1649,25907,1478
Hà Giang,2013,166,1808,47959,21974,41747,3887,2450,1783,25985,1437
Hà Giang,2014,167,1806,48349,22093,42757,3834,2386,1743,26256,1448
Hà Giang,2015,171,1786,49105,22742,43238,3873,2411,1726,26363,1462
Hà Giang,2016,171,1805,50353,23253,44646,3825,2389,1762,27100,1436
Hà Giang,2017,169,1808,52019,23942,45997,3807,2374,1775,28077,1433
Hà Giang,2018,162,1780,52891,24594,46918,3808,2294,1722,28297,1514
Hà Giang,2019,154,1785,55726,26025,49350,3589,2215,1668,29701,1374
Hà Giang,2020,154,1848,60556,28449,53688,3542,2194,1629,32107,1348
Hà Giang,2021,150,1905,64693,30634,57399,3487,2150,1637,34059,1337
Hà Nam,2004,121,1662,69861,33651,0,3264,2401,0,36210,863
Hà Nam,2005,121,1621,64981,31922,0,3247,2367,0,33059,880
Hà Nam,2006,121,1546,60113,29529,0,3219,2370,0,30584,849
Hà Nam,2007,121,1487,56092,27576,0,3289,2400,0,28516,889
Hà Nam,2008,120,1426,51845,25635,0,3178,2325,0,26210,853
Hà Nam,2009,120,1379,48837,24276,0,3311,2482,0,24561,829
Hà Nam,2010,120,1318,45852,22638,0,3187,2365,0,23214,822
Hà Nam,2011,120,1296,44741,21984,0,3055,2295,0,22757,760
Hà Nam,2012,120,1288,44047,21339,0,2963,2175,0,22708,788
Hà Nam,2013,119,1270,43308,21206,0,2956,2218,0,22102,738
Hà Nam,2014,118,1281,44219,21685,0,2941,2206,0,22534,735
Hà Nam,2015,118,1274,43716,21468,0,2846,2134,0,22248,712
Hà Nam,2016,118,1270,44159,21641,0,2826,2129,0,22518,697
Hà Nam,2017,118,1265,45168,22148,0,2326,1710,0,23020,616
Hà Nam,2018,116,1271,46159,22517,67,2448,1757,0,23642,691
Hà Nam,2019,115,1289,47896,23305,68,2379,1804,0,24591,575
Hà Nam,2020,108,1323,49616,23965,87,2441,1867,0,25651,574
Hà Nam,2021,107,1346,51057,24606,109,2436,1863,0,26451,573
Hà Nội,2004,215,4589,185484,89340,0,9713,7818,0,96144,1895
Hà Nội,2005,214,4527,180236,86497,0,9810,7902,0,93739,1908
Hà Nội,2006,218,4495,176734,85401,257,9628,7960,101,91333,1668
Hà Nội,2007,219,4474,174168,84156,364,9506,7813,109,90012,1693
Hà Nội,2008,584,9358,345685,170130,3567,20970,16650,161,175555,4320
Hà Nội,2009,581,9189,325360,158904,2638,20614,16722,123,166456,3892
Hà Nội,2010,589,9093,339170,165515,3069,20689,16459,161,173655,4230
Hà Nội,2011,595,9007,321695,154842,2997,20134,15932,136,166853,4202
Hà Nội,2012,599,9000,322676,155902,3408,20455,15607,111,166774,4848
Hà Nội,2013,605,9134,330531,160720,3711,20782,16095,133,169811,4687
Hà Nội,2014,607,9668,362453,176227,4306,20563,16159,168,186226,4404
Hà Nội,2015,617,11040,382044,184703,4435,21392,17324,191,197341,4068
Hà Nội,2016,610,10986,407550,195897,4877,21985,17765,188,211653,4220
Hà Nội,2017,605,11074,426924,203927,5272,21785,17670,198,222997,4115
Hà Nội,2018,608,11494,447906,212789,5762,18112,16910,233,235117,1202
Hà Nội,2019,610,12166,474429,224723,6059,19809,16150,268,249706,3659
Hà Nội,2020,614,12884,507901,239641,6460,21992,18204,303,268260,3788
Hà Nội,2021,621,13397,525213,247201,7785,22931,19029,343,278012,3902
Hà Tĩnh,2004,195,3601,141831,68756,0,6962,4627,0,73075,2335
Hà Tĩnh,2005,192,3523,137070,65742,0,6559,4266,0,71328,2293
Hà Tĩnh,2006,197,3489,131060,64933,0,6717,4404,0,66127,2313
Hà Tĩnh,2007,195,3282,121277,59521,0,6771,4469,0,61756,2302
Hà Tĩnh,2008,194,3084,109227,53202,0,6303,3988,0,56025,2315
Hà Tĩnh,2009,193,2934,100207,49588,0,6208,4075,0,50619,2133
Hà Tĩnh,2010,188,2758,90687,44195,0,6027,3915,0,46492,2112
Hà Tĩnh,2011,186,2643,86514,41814,0,5754,3627,0,44700,2127
Hà Tĩnh,2012,174,2607,81323,39299,0,5744,3822,0,42024,1922
Hà Tĩnh,2013,155,2470,75952,36834,0,5488,3559,0,39118,1929
Hà Tĩnh,2014,144,2427,75315,36914,0,5303,3403,0,38401,1900
Hà Tĩnh,2015,143,2395,75505,36529,0,5194,3248,0,38976,1946
Hà Tĩnh,2016,143,2375,74653,36205,0,5060,3162,0,38448,1898
Hà Tĩnh,2017,143,2383,75768,36943,0,4971,3147,0,38825,1824
Hà Tĩnh,2018,139,2374,75487,36505,172,4873,3088,0,38982,1785
Hà Tĩnh,2019,135,2370,75788,36638,210,4699,3030,0,39150,1669
Hà Tĩnh,2020,130,2366,78462,38122,253,4601,2993,0,40340,1608
Hà Tĩnh,2021,130,2368,78319,37397,296,4679,3051,0,40922,1628
Hòa Bình,2004,194,2144,72163,34630,56184,4522,3253,1426,37533,1269
Hòa Bình,2005,204,2190,68615,33320,53909,4519,3217,1472,35295,1302
Hòa Bình,2006,209,2103,64082,31036,50356,4733,3337,1551,33046,1396
Hòa Bình,2007,210,2118,59360,28748,45229,4698,3310,1539,30612,1388
Hòa Bình,2008,205,1996,51458,25472,39208,4572,3302,1637,25986,1270
Hòa Bình,2009,206,1967,45362,22382,34386,4326,3034,1475,22980,1292
Hòa Bình,2010,210,1763,44202,21397,32992,4551,3215,1819,22805,1336
Hòa Bình,2011,211,2041,42809,19305,29666,4143,2871,1736,23504,1272
Hòa Bình,2012,210,1839,43610,21102,32203,4437,3113,1653,22508,1324
Hòa Bình,2013,209,1704,43861,21435,33364,4102,2857,1548,22426,1245
Hòa Bình,2014,206,1800,45268,22129,34195,3998,2795,1556,23139,1203
Hòa Bình,2015,202,2388,45683,22211,34574,3946,2721,1481,23472,1225
Hòa Bình,2016,143,1786,47054,22914,35351,3907,2689,1464,24140,1218
Hòa Bình,2017,121,1918,48342,23564,36321,3755,2611,1383,24778,1144
Hòa Bình,2018,82,1752,50912,24835,38545,3399,2709,1360,26077,690
Hòa Bình,2019,44,1777,52708,25544,39748,3535,2807,1337,27164,728
Hòa Bình,2020,27,1811,55290,26693,41919,3598,2530,1404,28597,1068
Hòa Bình,2021,27,1837,57804,27870,44255,3501,2468,1372,29934,1033
Hưng Yên,2004,167,2284,98504,48578,0,4139,3407,0,49926,732
Hưng Yên,2005,168,2209,89282,43709,0,4291,3461,0,45573,830
Hưng Yên,2006,168,2110,81987,40630,0,4276,3372,0,41357,904
Hưng Yên,2007,169,2018,76917,38143,0,4338,3449,0,38774,889
Hưng Yên,2008,169,1928,69863,34645,0,4304,3095,0,35218,1209
Hưng Yên,2009,169,1861,66568,34895,0,4233,3275,0,31673,958
Hưng Yên,2010,169,1795,63568,31877,0,4304,3341,0,31691,963
Hưng Yên,2011,169,1769,62602,31450,0,4266,3351,0,31152,915
Hưng Yên,2012,169,1729,59929,29277,0,4368,3463,0,30652,905
Hưng Yên,2013,171,1897,59128,28891,0,4269,3386,0,30237,883
Hưng Yên,2014,171,1887,60343,29438,0,4253,3391,0,30905,862
Hưng Yên,2015,171,1939,59562,28658,0,4305,3465,0,30904,840
Hưng Yên,2016,171,1803,61615,29396,0,4286,3447,0,32219,839
Hưng Yên,2017,171,1866,64926,30604,0,4136,3330,0,34322,806
Hưng Yên,2018,164,1921,69402,32222,62,3660,3101,0,37180,559
Hưng Yên,2019,157,2002,74004,34077,60,3592,2872,0,39927,720
Hưng Yên,2020,148,2045,77829,35568,135,3589,2887,0,42261,702
Hưng Yên,2021,144,2088,80275,36695,171,3597,2889,0,43580,708
Hải Dương,2004,273,3510,140040,68087,0,6427,4930,0,71953,1497
Hải Dương,2005,273,3353,127540,61758,0,6366,4849,0,65782,1517
Hải Dương,2006,273,3252,118135,57125,310,6329,4817,0,61010,1512
Hải Dương,2007,273,3181,110792,54112,375,6354,4797,0,56680,1557
Hải Dương,2008,273,3077,103029,49981,390,6204,4684,0,53048,1520
Hải Dương,2009,273,3062,99745,47510,358,6180,4834,0,52235,1346
Hải Dương,2010,272,3051,95205,46079,342,6057,4738,0,49126,1319
Hải Dương,2011,272,3081,94868,46039,378,6163,4799,0,48829,1364
Hải Dương,2012,272,2932,95557,46633,339,6169,5238,0,48924,931
Hải Dương,2013,271,2873,90985,44053,341,5977,4657,0,46932,1320
Hải Dương,2014,272,2853,93823,45188,1028,5828,4541,0,48635,1287
Hải Dương,2015,272,2805,92037,44449,304,5821,4548,0,47588,1273
Hải Dương,2016,272,2811,92658,44261,333,5687,4458,0,48397,1229
Hải Dương,2017,273,2878,96305,45816,294,5590,4376,0,50489,1214
Hải Dương,2018,261,2906,100665,47300,331,4868,4116,0,53365,752
Hải Dương,2019,249,2915,105320,48931,332,4914,3855,0,56389,1059
Hải Dương,2020,241,3085,113510,52465,480,5022,3959,0,61045,1063
Hải Dương,2021,240,3180,119588,55202,558,5072,4012,0,64386,1060
Hải Phòng,2004,190,3481,137457,66625,0,7042,5613,0,70832,1429
Hải Phòng,2005,192,3364,128668,62378,0,6986,5299,0,66290,1687
Hải Phòng,2006,194,3231,120310,58473,0,6758,5372,0,61837,1386
Hải Phòng,2007,194,3077,113162,54966,0,6663,5328,0,58196,1335
Hải Phòng,2008,194,2880,103509,50160,0,6645,5157,0,53349,1488
Hải Phòng,2009,204,2910,96281,46694,0,6482,5248,0,49587,1234
Hải Phòng,2010,193,2574,90806,43245,0,6210,5004,0,47561,1206
Hải Phòng,2011,193,2619,88365,42309,0,5897,4755,0,46056,1142
Hải Phòng,2012,193,2454,88700,43166,0,5959,4855,0,45534,1104
Hải Phòng,2013,190,2969,87509,42691,0,5907,4781,0,44818,1126
Hải Phòng,2014,190,2560,92154,44574,0,5819,4691,0,47580,1128
Hải Phòng,2015,184,2562,93709,45579,0,5698,4600,0,48130,1098
Hải Phòng,2016,184,2612,96969,47161,0,5507,4437,0,49808,1070
Hải Phòng,2017,184,2688,103643,49826,0,5349,4305,0,53817,1044
Hải Phòng,2018,184,2757,109311,53493,61,5186,4156,0,55818,1030
Hải Phòng,2019,183,2871,117497,56703,73,4968,4007,0,60794,961
Hải Phòng,2020,181,3052,127159,61159,203,5335,4318,0,66000,1017
Hải Phòng,2021,181,3164,132516,63768,296,5346,4326,0,68748,1020
Hậu Giang,2004,43,1376,51066,24546,1176,2081,1103,0,26520,978
Hậu Giang,2005,43,1310,47779,23118,1153,2165,1149,0,24661,1016
Hậu Giang,2006,46,1231,44497,21711,1385,2226,1193,0,22786,1033
Hậu Giang,2007,49,1214,41027,20454,1243,2288,1275,0,20573,1013
Hậu Giang,2008,52,1074,39483,19394,734,2200,1229,0,20089,971
Hậu Giang,2009,54,992,37419,18664,1468,2188,1231,0,18755,957
Hậu Giang,2010,54,1096,37004,18439,1280,2212,1274,0,18565,938
Hậu Giang,2011,59,1101,39442,18647,1784,2151,1229,0,20795,922
Hậu Giang,2012,59,1109,39771,19585,1328,2272,1270,0,20186,1002
Hậu Giang,2013,61,1141,41728,20770,1364,2252,1283,0,20958,969
Hậu Giang,2014,61,1183,43800,21946,1139,2029,1165,0,21854,864
Hậu Giang,2015,61,1195,43747,21553,1300,2312,1286,0,22194,1026
Hậu Giang,2016,61,1206,44557,22016,1338,2293,1330,0,22541,963
Hậu Giang,2017,61,1211,45557,22561,1386,2326,1349,0,22996,977
Hậu Giang,2018,61,1203,70900,22196,1475,2304,1324,0,48704,980
Hậu Giang,2019,61,1191,45641,22431,1625,2229,1298,0,23210,931
Hậu Giang,2020,62,1203,47260,23349,1745,2202,1284,0,23911,918
Hậu Giang,2021,62,1179,45094,22150,1690,2162,1261,0,22944,901
Khánh Hòa,2004,78,2286,93167,45788,2925,3820,2679,8,47379,1141
Khánh Hòa,2005,82,2351,92970,45097,3505,4099,2908,14,47873,1191
Khánh Hòa,2006,86,2356,91583,45183,4030,4295,3067,24,46400,1228
Khánh Hòa,2007,87,2287,85655,42918,4036,4391,3128,26,42737,1263
Khánh Hòa,2008,96,2218,80436,40138,3691,4298,3307,31,40298,991
Khánh Hòa,2009,100,2192,75137,37580,3735,4203,2995,31,37557,1208
Khánh Hòa,2010,103,2167,71845,35989,3772,4177,2988,32,35856,1189
Khánh Hòa,2011,104,2189,72236,35346,3875,4126,2919,33,36890,1207
Khánh Hòa,2012,105,2202,71661,35582,4431,4222,2991,34,36079,1231
Khánh Hòa,2013,107,2254,73789,36714,4658,4163,2965,49,37075,1198
Khánh Hòa,2014,108,2277,75679,37613,4714,4251,3027,55,38066,1224
Khánh Hòa,2015,110,2285,74872,37285,4745,4275,3056,59,37587,1219
Khánh Hòa,2016,111,2270,75536,37612,4684,4185,3006,56,37924,1179
Khánh Hòa,2017,111,2241,76088,37641,4953,4218,3076,59,38447,1142
Khánh Hòa,2018,111,2202,75330,37096,5119,4078,2967,64,38234,1111
Khánh Hòa,2019,111,2101,75603,37118,5129,3893,2858,68,38485,1035
Khánh Hòa,2020,108,2045,77535,38051,5400,3751,2768,68,39484,983
Khánh Hòa,2021,109,1973,72893,35765,5141,3643,2710,65,37128,933
Kiên Giang,2004,113,2981,116225,54194,13994,4682,2565,189,62031,2117
Kiên Giang,2005,117,3006,113933,53433,13952,4973,2729,202,60500,2244
Kiên Giang,2006,120,2976,109476,52179,13660,5067,2986,234,57297,2081
Kiên Giang,2007,124,2814,100869,48783,11667,5208,2915,238,52086,2293
Kiên Giang,2008,124,2770,96008,47247,11430,5368,3097,251,48761,2271
Kiên Giang,2009,130,2715,90857,44475,10950,5387,3074,270,46382,2313
Kiên Giang,2010,129,2625,85708,42539,10461,5366,3101,269,43169,2265
Kiên Giang,2011,128,2626,87915,43505,10542,5347,3068,264,44410,2279
Kiên Giang,2012,124,2648,89493,44539,10697,5423,3028,259,44954,2395
Kiên Giang,2013,121,2721,92321,45945,11058,5358,3012,286,46376,2346
Kiên Giang,2014,122,2750,94883,47514,10752,5276,2995,304,47369,2281
Kiên Giang,2015,122,2748,94270,47104,11030,5322,3005,305,47166,2317
Kiên Giang,2016,124,2774,94705,47115,11428,5329,2980,317,47590,2349
Kiên Giang,2017,123,2791,96630,48051,12148,5295,2998,321,48579,2297
Kiên Giang,2018,121,2718,67062,47215,12316,5348,2952,342,19847,2396
Kiên Giang,2019,119,2624,98490,48384,12775,5155,2905,364,50106,2250
Kiên Giang,2020,110,2627,102830,50694,13538,5092,2860,358,52136,2232
Kiên Giang,2021,104,2614,98936,48698,13244,4930,2787,343,50238,2143
Kon Tum,2004,60,919,31430,15143,0,1923,1246,66,16287,677
Kon Tum,2005,63,986,35146,17053,0,2251,1480,77,18093,771
Kon Tum,2006,76,1294,35311,17413,18602,2151,1401,87,17898,750
Kon Tum,2007,81,1339,36192,18284,19862,2174,1504,69,17908,670
Kon Tum,2008,85,1106,35882,17644,20054,2223,1546,87,18238,677
Kon Tum,2009,87,1079,34760,17647,20551,2411,1645,85,17113,766
Kon Tum,2010,91,1173,34534,17621,20982,2472,1729,90,16913,743
Kon Tum,2011,94,1146,35324,17684,21449,2479,1694,100,17640,785
Kon Tum,2012,100,1144,35386,17933,21546,2598,1659,109,17453,939
Kon Tum,2013,100,1145,35832,18498,21846,2655,1834,185,17334,821
Kon Tum,2014,101,1156,36553,18622,21568,2660,1841,203,17931,819
Kon Tum,2015,104,1168,36765,18628,21743,2593,1790,186,18137,803
Kon Tum,2016,106,1196,37707,19088,22397,2636,1828,200,18619,808
Kon Tum,2017,107,1212,38656,19601,22950,2587,1805,203,19055,782
Kon Tum,2018,95,1199,39078,19929,23201,2491,1788,206,19149,703
Kon Tum,2019,83,1212,40240,20593,23776,2476,1771,208,19647,705
Kon Tum,2020,62,1227,41812,21460,24579,2477,1768,224,20352,709
Kon Tum,2021,57,1249,42121,21470,25066,2408,1718,230,20651,690
Lai Châu,2004,42,671,16308,5856,13194,1113,611,149,10452,502
Lai Châu,2005,65,629,17629,6482,14738,1332,729,187,11147,603
Lai Châu,2006,81,730,20151,7513,17252,1619,876,224,12638,743
Lai Châu,2007,86,803,21243,8217,18393,1791,948,235,13026,843
Lai Châu,2008,97,862,23132,9096,20629,1856,977,354,14036,879
Lai Châu,2009,105,929,24830,9927,21683,1869,1026,429,14903,843
Lai Châu,2010,109,967,25532,10363,23348,1948,1048,436,15169,900
Lai Châu,2011,109,983,26395,11038,24115,2094,1148,467,15357,946
Lai Châu,2012,112,1023,27284,11870,24939,2040,1142,498,15414,898
Lai Châu,2013,122,1021,27976,12482,25488,2212,1264,582,15494,948
Lai Châu,2014,116,1025,29627,13471,26838,2205,1275,551,16156,930
Lai Châu,2015,113,1039,31594,14554,28711,2118,1212,568,17040,906
Lai Châu,2016,113,1078,33012,15339,29839,2104,1232,573,17673,872
Lai Châu,2017,113,1099,35302,16575,31770,2051,1217,549,18727,834
Lai Châu,2018,103,1091,36890,17382,32935,2076,1221,556,19508,855
Lai Châu,2019,93,1098,38164,18046,33651,2084,1225,563,20118,859
Lai Châu,2020,91,1118,39615,18913,34774,2029,1180,550,20702,849
Lai Châu,2021,88,1123,40387,19407,35239,1979,1150,546,20980,829
Long An,2004,104,2562,99601,48649,0,4376,3067,0,50952,1309
Long An,2005,108,2451,94971,45976,0,4367,3082,0,48995,1285
Long An,2006,115,2432,92097,45112,0,4275,3058,0,46985,1217
Long An,2007,114,2321,87593,43280,0,4473,3175,0,44313,1298
Long An,2008,115,2292,84814,43255,0,4579,3250,0,41559,1329
Long An,2009,122,2231,81524,40260,0,4812,3372,0,41264,1440
Long An,2010,122,2231,80853,39640,0,4754,3326,0,41213,1428
Long An,2011,122,2253,81192,39398,0,4775,3355,0,41794,1420
Long An,2012,122,2252,80185,39288,0,5077,3526,0,40897,1551
Long An,2013,122,2323,83689,40859,0,4984,3438,0,42830,1546
Long An,2014,126,2377,89037,43530,0,4957,3411,0,45507,1546
Long An,2015,132,2417,90578,44355,0,4856,3321,0,46223,1535
Long An,2016,132,2421,92744,45392,0,4789,3280,0,47352,1509
Long An,2017,133,2439,94257,46355,0,4731,3232,0,47902,1499
Long An,2018,124,2389,100064,45675,262,4626,3134,0,54389,1492
Long An,2019,114,2426,95127,46750,290,4493,3035,0,48377,1458
Long An,2020,110,2521,100343,49225,345,4326,2908,0,51118,1418
Long An,2021,112,2502,97869,47977,333,4245,2836,0,49892,1409
Lào Cai,2004,158,1928,56558,24714,37716,3028,2106,360,31844,922
Lào Cai,2005,178,1933,55528,24929,38629,3137,2119,383,30599,1018
Lào Cai,2006,186,1857,53423,24616,37217,3411,2300,447,28807,1111
Lào Cai,2007,186,1692,50149,23240,35128,3307,2191,432,26909,1116
Lào Cai,2008,187,1625,47935,22103,33741,3398,2277,529,25832,1121
Lào Cai,2009,187,1577,45997,21332,32822,3483,2473,596,24665,1010
Lào Cai,2010,188,1504,44074,20484,32515,3565,2253,430,23590,1312
Lào Cai,2011,191,1537,44228,20780,32289,3558,2357,604,23448,1201
Lào Cai,2012,189,1510,43637,20380,32263,3521,2264,778,23257,1257
Lào Cai,2013,190,1518,43875,20669,32325,3471,2191,808,23206,1280
Lào Cai,2014,184,1620,44900,21166,32481,3503,2322,788,23734,1181
Lào Cai,2015,178,1573,46341,21809,33726,3508,2294,818,24532,1214
Lào Cai,2016,168,1599,47888,22532,34864,3374,2213,772,25356,1161
Lào Cai,2017,163,1653,50046,23654,36373,3353,2204,812,26392,1149
Lào Cai,2018,156,1627,51347,24324,36959,3278,2106,775,27023,1172
Lào Cai,2019,150,1636,53821,25569,38692,3061,2009,738,28252,1052
Lào Cai,2020,147,1688,56566,26768,40467,3085,1999,790,29798,1086
Lào Cai,2021,145,1716,58121,27721,41589,3114,2039,836,30400,1075
Lâm Đồng,2004,97,2442,98664,47598,19268,4348,2929,86,51066,1419
Lâm Đồng,2005,125,2511,99203,49095,21610,4477,3009,97,50108,1468
Lâm Đồng,2006,108,2488,97342,47457,24534,4578,3085,98,49885,1493
Lâm Đồng,2007,109,2573,96045,51154,21673,4733,2857,119,44891,1876
Lâm Đồng,2008,114,2586,95415,48289,21192,4873,2980,165,47126,1893
Lâm Đồng,2009,122,2547,90702,45983,22350,4885,3310,192,44719,1575
Lâm Đồng,2010,145,2674,87717,44147,22130,4970,3432,218,43570,1538
Lâm Đồng,2011,133,2516,87368,42724,21759,4741,3269,225,44644,1472
Lâm Đồng,2012,137,2521,85496,41608,20997,5276,3253,232,43888,2023
Lâm Đồng,2013,140,2554,85901,42862,21619,4757,3370,218,43039,1387
Lâm Đồng,2014,141,2553,84660,42345,20373,4973,3500,263,42315,1473
Lâm Đồng,2015,142,2513,81898,40280,20023,4962,3476,273,41618,1486
Lâm Đồng,2016,143,2499,81316,40596,19904,4937,3451,286,40720,1486
Lâm Đồng,2017,145,2502,81960,40837,20083,4868,3340,301,41123,1528
Lâm Đồng,2018,144,2488,84668,41790,20491,4581,3306,306,42878,1275
Lâm Đồng,2019,143,2495,88191,43567,21280,4667,3273,312,44624,1394
Lâm Đồng,2020,140,2540,92066,45238,22597,4706,3314,312,46828,1392
Lâm Đồng,2021,135,2501,90926,44668,23372,4608,3267,322,46258,1341
Lạng Sơn,2004,115,2216,72900,35887,62080,4434,3315,3163,37013,1119
Lạng Sơn,2005,131,2214,71259,35218,60979,4385,3232,3172,36041,1153
Lạng Sơn,2006,174,2199,67372,33372,57993,4425,3222,3196,34000,1203
Lạng Sơn,2007,179,2089,61874,30922,53398,4558,3357,3282,30952,1201
Lạng Sơn,2008,181,2073,56464,28299,49110,4518,3283,3282,28165,1235
Lạng Sơn,2009,202,1955,51946,25923,45158,4472,3209,3196,26023,1263
Lạng Sơn,2010,202,1847,46760,23081,40716,4355,3132,3179,23679,1223
Lạng Sơn,2011,204,1806,45308,22313,39347,4213,3033,3156,22995,1180
Lạng Sơn,2012,203,1801,43836,21524,38125,4027,2903,3133,22312,1124
Lạng Sơn,2013,204,1745,42787,20914,37120,4125,2958,3083,21873,1167
Lạng Sơn,2014,207,1741,43736,21264,37772,3965,2842,2964,22472,1123
Lạng Sơn,2015,207,1685,43831,21373,37839,3899,2780,2929,22458,1119
Lạng Sơn,2016,206,1657,43842,21455,37634,3822,2720,2789,22387,1102
Lạng Sơn,2017,198,1631,44403,21613,38043,3713,2640,2759,22790,1073
Lạng Sơn,2018,182,1604,44521,21719,37896,3456,2454,2564,22802,1002
Lạng Sơn,2019,167,1577,44567,21684,37730,3223,2268,2370,22883,955
Lạng Sơn,2020,149,1581,46398,22426,39334,3186,2236,2354,23972,950
Lạng Sơn,2021,145,1602,48991,23468,41701,3186,2214,2325,25523,972
Nam Định,2004,245,4829,163307,80428,0,7178,5292,0,82879,1886
Nam Định,2005,245,3656,154427,75232,0,7257,5304,0,79195,1953
Nam Định,2006,245,3555,145382,71237,0,7260,5114,0,74145,2146
Nam Định,2007,245,3355,138085,66505,0,7012,5157,0,71580,1855
Nam Định,2008,245,3271,126086,62054,0,7071,5097,0,64032,1974
Nam Định,2009,245,3175,118782,58936,0,7451,5493,0,59846,1958
Nam Định,2010,245,3092,113928,54343,0,6766,5039,0,59585,1727
Nam Định,2011,246,3006,109527,53314,0,6782,5032,0,56213,1750
Nam Định,2012,246,3128,106138,51881,0,6793,5078,0,54257,1715
Nam Định,2013,246,2944,104147,50830,0,6657,4937,0,53317,1720
Nam Định,2014,242,2967,104534,50993,0,6539,4879,0,53541,1660
Nam Định,2015,242,2934,101371,49833,0,6308,4696,0,51538,1612
Nam Định,2016,237,2920,101395,49667,0,6278,4666,0,51728,1612
Nam Định,2017,237,2928,103183,50479,0,6232,4635,0,52704,1597
Nam Định,2018,233,2899,104384,50959,124,5954,4478,0,53425,1476
Nam Định,2019,229,2940,109221,52991,150,5793,4322,0,56230,1471
Nam Định,2020,226,2971,114552,55210,231,5717,4266,0,59342,1451
Nam Định,2021,226,2994,115975,55531,267,5630,4229,0,60444,1401
Nghệ An,2004,443,7750,317216,150164,40030,14484,8428,753,167052,6056
Nghệ An,2005,440,7668,304974,148168,42872,14225,9308,652,156806,4917
Nghệ An,2006,436,7544,293087,142365,41562,14474,9443,647,150722,5031
Nghệ An,2007,438,7199,265597,131426,34595,14266,9295,616,134171,4971
Nghệ An,2008,427,6727,237991,115657,34823,13854,9075,737,122334,4779
Nghệ An,2009,405,6305,217730,106474,32688,13644,8926,742,111256,4718
Nghệ An,2010,398,5907,195292,94577,29886,13685,8919,767,100715,4766
Nghệ An,2011,386,5694,184044,88598,29046,13252,8283,842,95446,4969
Nghệ An,2012,388,5573,177208,85400,28312,13262,8700,918,91808,4562
Nghệ An,2013,389,5487,170485,82364,27934,12843,8884,905,88121,3959
Nghệ An,2014,388,5547,170963,82844,28190,12495,8352,899,88119,4143
Nghệ An,2015,393,5487,173491,84426,29182,12182,8022,888,89065,4160
Nghệ An,2016,390,5444,175171,85085,29453,11837,7828,891,90086,4009
Nghệ An,2017,391,5234,178684,86256,30159,11454,7624,866,92428,3830
Nghệ An,2018,384,5061,182557,88265,31155,10781,7280,852,94292,3501
Nghệ An,2019,377,5059,184934,89130,31387,10293,6937,839,95804,3356
Nghệ An,2020,372,5167,194188,93468,32623,10167,6906,841,100720,3261
Nghệ An,2021,370,5220,197051,94375,33290,9940,6778,820,102676,3162
Ninh Bình,2004,143,2116,87159,42180,2568,3788,2920,0,44979,868
Ninh Bình,2005,143,2011,79841,38448,2689,3685,3062,0,41393,623
Ninh Bình,2006,143,1879,72676,34601,2272,3705,2867,19,38075,838
Ninh Bình,2007,144,1768,65644,32038,2048,3518,2696,20,33606,822
Ninh Bình,2008,144,1630,57411,26593,2090,3345,2292,18,30818,1053
Ninh Bình,2009,143,1532,52780,25622,1731,3421,2667,29,27158,754
Ninh Bình,2010,143,1470,49055,23702,1518,3346,2624,34,25353,722
Ninh Bình,2011,143,1445,48241,22356,772,3304,2450,34,25885,854
Ninh Bình,2012,142,1444,47543,22748,1594,3324,2570,35,24795,754
Ninh Bình,2013,142,1445,47234,23076,1559,3304,2457,43,24158,847
Ninh Bình,2014,142,1476,48893,23797,1601,3352,2625,55,25096,727
Ninh Bình,2015,142,1483,48613,23534,1661,3345,2614,58,25079,731
Ninh Bình,2016,142,1495,49735,24241,1683,3329,2612,52,25494,717
Ninh Bình,2017,142,1507,51474,25058,1864,3240,2545,55,26416,695
Ninh Bình,2018,142,1503,52523,25755,2028,3211,2514,60,26768,697
Ninh Bình,2019,142,1525,54233,26461,2212,3149,2484,65,27772,665
Ninh Bình,2020,139,1571,56641,27449,2338,3163,2493,65,29192,670
Ninh Bình,2021,134,1571,57346,27651,2443,2963,2337,67,29695,626
Ninh Thuận,2004,44,1124,45540,27776,8078,1808,1099,209,17764,709
Ninh Thuận,2005,45,1140,45650,24094,8488,1879,1190,272,21556,689
Ninh Thuận,2006,51,1149,46105,23407,8994,2045,1318,316,22698,727
Ninh Thuận,2007,51,1113,42625,22034,8910,2018,1261,310,20591,757
Ninh Thuận,2008,55,1092,41181,20343,9215,2098,1329,336,20838,769
Ninh Thuận,2009,59,1098,38260,19812,8575,2077,1334,335,18448,743
Ninh Thuận,2010,60,1096,36575,16081,7631,2237,1495,324,20494,742
Ninh Thuận,2011,63,1104,37084,18948,9112,2082,1333,336,18136,749
Ninh Thuận,2012,63,1113,36389,18907,9124,2023,1287,347,17482,736
Ninh Thuận,2013,63,1120,36650,18930,9327,2172,1398,379,17720,774
Ninh Thuận,2014,64,1129,37242,19299,9421,2203,1410,373,17943,793
Ninh Thuận,2015,64,1104,37091,19048,9342,2166,1386,398,18043,780
Ninh Thuận,2016,64,1101,37272,19287,9464,2163,1389,395,17985,774
Ninh Thuận,2017,64,1092,37514,19259,9513,2163,1397,401,18255,766
Ninh Thuận,2018,61,1023,34942,17830,8795,1876,1325,384,17112,551
Ninh Thuận,2019,58,1041,37097,18815,9558,1942,1253,366,18282,689
Ninh Thuận,2020,53,1047,38632,19517,10050,1931,1259,382,19115,672
Ninh Thuận,2021,50,1037,37983,19201,10068,1886,1247,381,18782,639
Phú Thọ,2004,247,3216,118799,56052,20917,6130,4335,437,62747,1795
Phú Thọ,2005,249,3103,110336,52751,18373,6149,4338,396,57585,1811
Phú Thọ,2006,249,3005,102840,49861,16582,5857,4154,376,52979,1703
Phú Thọ,2007,250,2901,94031,45144,15743,6050,4234,501,48887,1816
Phú Thọ,2008,250,2730,84131,40657,14168,6071,3961,493,43474,2110
Phú Thọ,2009,252,2619,78002,38227,13498,6029,3995,517,39775,2034
Phú Thọ,2010,252,2470,70783,34365,12321,5972,4308,492,36418,1664
Phú Thọ,2011,251,2440,70117,33934,12211,5796,4147,499,36183,1649
Phú Thọ,2012,253,2423,69779,33830,12348,5824,4138,506,35949,1686
Phú Thọ,2013,253,2421,69633,34048,12661,5837,4139,552,35585,1698
Phú Thọ,2014,253,2450,73330,35320,13227,5837,4402,583,38010,1435
Phú Thọ,2015,254,2475,74768,36300,13966,5898,4189,630,38468,1709
Phú Thọ,2016,254,2488,76546,37086,14452,5874,4153,638,39460,1721
Phú Thọ,2017,254,2502,79180,38083,14831,5706,4070,610,41097,1636
Phú Thọ,2018,251,2512,82688,39497,15906,5195,3849,604,43191,1346
Phú Thọ,2019,248,2522,86425,41195,16599,4993,3628,598,45230,1365
Phú Thọ,2020,248,2635,92844,44217,17741,5019,3667,576,48627,1352
Phú Thọ,2021,243,2735,98138,46848,19521,5099,3715,583,51290,1384
Phú Yên,2004,90,3169,69915,31414,2897,3624,2182,0,38501,1442
Phú Yên,2005,92,1901,73108,35161,3324,3935,2366,0,37947,1569
Phú Yên,2006,92,1898,70107,34247,3510,4128,2514,21,35860,1614
Phú Yên,2007,99,1883,65856,32744,3279,4005,2388,19,33112,1617
Phú Yên,2008,93,1827,64185,31628,4054,4120,2462,23,32557,1658
Phú Yên,2009,96,1758,59279,29217,3042,3986,2366,21,30062,1620
Phú Yên,2010,96,1715,57156,28287,2993,4025,2401,27,28869,1624
Phú Yên,2011,99,1886,63403,31418,3160,4302,2603,28,31985,1699
Phú Yên,2012,100,1840,58001,28622,3517,4122,2527,30,29379,1595
Phú Yên,2013,101,1749,59019,29132,3695,4178,2563,32,29887,1615
Phú Yên,2014,101,1763,59180,29295,3945,4091,2507,31,29885,1584
Phú Yên,2015,101,1747,58290,28726,4053,4013,2455,33,29564,1558
Phú Yên,2016,102,1728,57298,28301,4103,4029,2470,31,28997,1559
Phú Yên,2017,104,1724,57079,28433,4089,3924,2393,33,28646,1531
Phú Yên,2018,84,1682,56218,27974,4131,3694,2298,32,28244,1396
Phú Yên,2019,65,1634,55504,27505,4204,3580,2203,31,27999,1377
Phú Yên,2020,65,1628,56194,27734,4316,3424,2096,29,28460,1328
Phú Yên,2021,65,1575,53473,26255,4371,3297,2028,29,27218,1269
Quảng Bình,2004,144,2216,88291,42359,921,4011,2635,0,45932,1376
Quảng Bình,2005,144,2222,86288,41858,897,4081,2676,0,44430,1405
Quảng Bình,2006,144,2174,82948,40072,1182,4164,2579,0,42876,1585
Quảng Bình,2007,146,2099,76234,34816,1101,4134,2728,0,41418,1406
Quảng Bình,2008,147,1994,70100,33896,1361,3953,2570,0,36204,1383
Quảng Bình,2009,148,1944,64528,30829,1389,3857,2506,0,33699,1351
Quảng Bình,2010,148,1817,58538,28645,1672,3679,2362,0,29893,1317
Quảng Bình,2011,148,1929,55822,27066,1727,3598,2320,0,28756,1278
Quảng Bình,2012,148,1742,53854,26258,1855,3657,2337,0,27596,1320
Quảng Bình,2013,148,1727,52814,25839,2130,3544,2271,0,26975,1273
Quảng Bình,2014,148,1771,54363,26740,2363,3558,2291,0,27623,1267
Quảng Bình,2015,148,1770,54576,26719,2396,3600,2348,0,27857,1252
Quảng Bình,2016,148,1718,54195,26556,2391,3431,2269,0,27639,1162
Quảng Bình,2017,147,1676,54647,26613,2357,3367,2261,0,28034,1106
Quảng Bình,2018,142,1615,53873,26284,2395,2977,2184,0,27589,793
Quảng Bình,2019,138,1606,54725,26694,2463,3018,2106,0,28031,912
Quảng Bình,2020,137,1659,57346,28008,2529,2944,2089,0,29338,855
Quảng Bình,2021,137,1636,56036,27234,2596,2927,2079,0,28802,848
Quảng Nam,2004,176,3399,139107,66207,10870,5465,3296,21,72900,2169
Quảng Nam,2005,184,3471,136560,64563,12504,5911,3605,2,71997,2306
Quảng Nam,2006,189,3351,131465,63432,13591,5998,3721,10,68033,2277
Quảng Nam,2007,192,3221,122756,59889,11595,6046,3774,13,62867,2272
Quảng Nam,2008,194,3093,112938,55275,9749,5936,3732,51,57663,2204
Quảng Nam,2009,193,2938,108451,50730,9976,6076,3984,108,57721,2092
Quảng Nam,2010,191,2833,100535,48053,11772,6028,3805,102,52482,2223
Quảng Nam,2011,193,2729,96061,46653,11424,5942,3757,114,49408,2185
Quảng Nam,2012,193,2654,91269,44417,10718,6039,3775,125,46852,2264
Quảng Nam,2013,190,2699,89284,43535,10477,5916,3739,145,45749,2177
Quảng Nam,2014,195,2638,88431,43116,10381,6026,3823,185,45315,2203
Quảng Nam,2015,195,2599,86768,42355,10443,6034,3847,207,44413,2187
Quảng Nam,2016,198,2606,86792,42328,10842,5964,3818,216,44464,2146
Quảng Nam,2017,197,2579,86862,42344,11014,5743,3704,218,44518,2039
Quảng Nam,2018,192,2533,87087,42634,11166,5195,3515,215,44453,1680
Quảng Nam,2019,188,2425,89053,43342,11562,5112,3326,212,45711,1786
Quảng Nam,2020,185,2482,90974,44093,11773,4829,3183,213,46881,1646
Quảng Nam,2021,179,2467,90077,43496,12118,4829,3212,265,46581,1617
Quảng Ngãi,2004,134,2890,118229,56027,10974,4669,2708,44,62202,1961
Quảng Ngãi,2005,140,2929,117423,57137,11671,4854,2873,45,60286,1981
Quảng Ngãi,2006,145,2851,113117,56026,12034,4917,3079,55,57091,1838
Quảng Ngãi,2007,153,2765,105875,52645,12071,5019,2971,69,53230,2048
Quảng Ngãi,2008,165,2626,98302,47215,11945,5040,3031,78,51087,2009
Quảng Ngãi,2009,165,2498,89671,43997,11833,5163,3232,96,45674,1931
Quảng Ngãi,2010,165,2355,81498,38877,11983,5191,3170,106,42621,2021
Quảng Ngãi,2011,166,2273,76645,37202,10858,5090,3108,118,39443,1982
Quảng Ngãi,2012,166,2239,73277,35251,11695,5277,3206,131,38026,2071
Quảng Ngãi,2013,161,2199,70678,34012,10695,5063,3069,109,36666,1994
Quảng Ngãi,2014,166,2594,70603,34230,12229,5100,3139,124,36373,1961
Quảng Ngãi,2015,168,3022,71791,35327,12851,5146,3209,128,36464,1937
Quảng Ngãi,2016,168,2240,72404,35335,13597,5077,3198,121,37069,1879
Quảng Ngãi,2017,168,2986,73698,36304,14078,4900,3105,126,37394,1795
Quảng Ngãi,2018,157,2222,73930,36097,14254,4396,2984,125,37833,1412
Quảng Ngãi,2019,146,2224,75586,36826,14553,4400,2863,124,38760,1537
Quảng Ngãi,2020,133,2270,77928,37923,14944,4306,2833,138,40005,1473
Quảng Ngãi,2021,130,2200,74792,36351,15051,4188,2793,142,38441,1395
Quảng Ninh,2004,127,2359,86928,42417,10260,4625,4091,149,44511,534
Quảng Ninh,2005,135,2369,85433,41337,10088,4952,4133,150,44096,819
Quảng Ninh,2006,137,2304,83616,37906,9884,4893,3980,168,45710,913
Quảng Ninh,2007,139,2304,79415,38895,10782,4868,4006,179,40520,862
Quảng Ninh,2008,139,2181,73748,35931,10648,4813,3959,217,37817,854
Quảng Ninh,2009,140,2161,70360,34508,10305,4743,3885,226,35852,858
Quảng Ninh,2010,143,2073,66774,32381,9984,4667,3814,239,34393,853
Quảng Ninh,2011,146,2441,66089,32195,9831,4527,3717,244,33894,810
Quảng Ninh,2012,149,2104,65712,32160,9688,4522,3711,249,33552,811
Quảng Ninh,2013,153,2139,65642,31764,9639,4617,3753,277,33878,864
Quảng Ninh,2014,151,2094,64609,30913,8758,4151,3422,234,33696,729
Quảng Ninh,2015,150,2127,68223,33023,9715,4161,3392,266,35200,769
Quảng Ninh,2016,150,2074,69320,33376,9777,4122,3362,278,35944,760
Quảng Ninh,2017,148,2103,72758,34885,10059,4028,3295,280,37873,733
Quảng Ninh,2018,144,2127,75923,36219,10022,4594,3259,280,39704,1335
Quảng Ninh,2019,141,2212,81483,38736,10630,3909,3223,279,42747,686
Quảng Ninh,2020,135,2309,87382,41777,11127,4001,3323,316,45605,678
Quảng Ninh,2021,133,2347,89859,43064,11668,3890,3225,311,46795,665
Quảng Trị,2004,94,1583,61542,29394,3507,3045,1735,26,32148,1310
Quảng Trị,2005,98,1619,61753,29715,3889,3319,1840,49,32038,1479
Quảng Trị,2006,102,1639,61177,29389,4374,3434,1911,64,31788,1523
Quảng Trị,2007,106,1595,57259,28521,4675,3427,1951,70,28738,1476
Quảng Trị,2008,108,1554,53849,26162,5176,3300,1884,86,27687,1416
Quảng Trị,2009,111,1516,51187,24255,6444,3383,1949,89,26932,1434
Quảng Trị,2010,111,1464,46610,22435,6033,3273,1857,83,24175,1416
Quảng Trị,2011,116,1399,45011,21552,6265,3189,1782,92,23459,1407
Quảng Trị,2012,115,1347,43096,20437,6607,3198,1818,102,22659,1380
Quảng Trị,2013,114,1314,42036,20422,7059,3112,1704,110,21614,1408
Quảng Trị,2014,113,1309,42534,20707,7585,2944,1676,110,21827,1268
Quảng Trị,2015,112,1319,42349,20646,7764,2973,1709,113,21703,1264
Quảng Trị,2016,112,1301,42519,20763,7864,2878,1705,111,21756,1173
Quảng Trị,2017,112,1297,42674,20851,7968,2758,1661,113,21823,1097
Quảng Trị,2018,80,1205,36927,16641,3803,2624,1590,116,20286,1034
Quảng Trị,2019,49,1224,40209,19110,7383,2533,1519,120,21099,1014
Quảng Trị,2020,43,1286,44757,21630,8064,2558,1563,119,23127,995
Quảng Trị,2021,42,1264,43903,21351,8215,2571,1581,121,22552,990
Sóc Trăng,2004,90,2080,79524,37855,21679,3585,1719,398,41669,1866
Sóc Trăng,2005,94,2039,76537,36451,20924,3667,1764,385,40086,1903
Sóc Trăng,2006,95,1929,71766,34455,19567,3706,1806,480,37311,1900
Sóc Trăng,2007,98,1855,66881,29019,18057,3766,1781,565,37862,1985
Sóc Trăng,2008,100,1822,64216,32631,16932,4091,1980,594,31585,2111
Sóc Trăng,2009,102,1816,61952,31478,16336,4082,1975,592,30474,2107
Sóc Trăng,2010,101,1838,60476,30068,15495,4037,2071,696,30408,1966
Sóc Trăng,2011,103,1927,64050,31756,17090,4281,2106,700,32294,2175
Sóc Trăng,2012,111,1968,66073,33188,18807,4367,2056,705,32885,2311
Sóc Trăng,2013,110,2000,69635,34818,21661,4368,2168,1165,34817,2200
Sóc Trăng,2014,113,2079,72905,35823,21980,4416,2196,900,37082,2220
Sóc Trăng,2015,111,2064,72262,36034,22352,4491,2232,981,36228,2259
Sóc Trăng,2016,110,1979,72809,36271,23400,4416,2194,1006,36538,2222
Sóc Trăng,2017,110,1931,72503,36395,23642,4352,2168,998,36108,2184
Sóc Trăng,2018,108,1950,45953,35607,23999,4211,2114,1007,10346,2097
Sóc Trăng,2019,106,1939,71703,35657,24528,4052,2059,1016,36046,1993
Sóc Trăng,2020,95,1975,74018,36815,25600,3944,2014,997,37203,1930
Sóc Trăng,2021,94,1955,70398,35058,24315,3839,1968,978,35340,1871
Sơn La,2004,149,2369,78324,32620,64077,4382,2678,817,45704,1704
Sơn La,2005,178,2522,80857,35699,65094,4851,2851,1047,45158,2000
Sơn La,2006,192,2629,83740,36042,67032,4965,3097,980,47698,1868
Sơn La,2007,204,2641,82253,35611,69138,5174,3219,1050,46642,1955
Sơn La,2008,209,2603,78515,34075,66495,5489,3250,1229,44440,2239
Sơn La,2009,221,2693,76325,32962,65366,5099,3116,2006,43363,1983
Sơn La,2010,223,2993,74183,32343,60324,5224,3265,1256,41840,1959
Sơn La,2011,228,2463,69280,30497,59643,5163,3261,1335,38783,1902
Sơn La,2012,229,2613,70063,31066,60149,5103,3217,1414,38997,1886
Sơn La,2013,231,2464,71919,32214,61966,5098,3206,1424,39705,1892
Sơn La,2014,231,2482,75514,34350,64887,5104,3220,1475,41164,1884
Sơn La,2015,231,2504,78876,36141,67871,5116,3214,1524,42735,1902
Sơn La,2016,230,2503,82522,38348,71172,5099,3203,1521,44174,1896
Sơn La,2017,220,2513,85935,40100,74540,5065,3171,1558,45835,1894
Sơn La,2018,150,2498,88921,41826,77133,4781,3040,1510,47095,1741
Sơn La,2019,81,2515,91938,43582,79505,4691,2909,1463,48356,1782
Sơn La,2020,80,2566,95280,45386,82077,4772,2974,1520,49894,1798
Sơn La,2021,80,2626,98443,47296,84568,4792,2978,1595,51147,1814
TP.Hồ Chí Minh,2004,223,7172,310281,149076,14545,13356,9504,0,161205,3852
TP.Hồ Chí Minh,2005,232,7286,313804,149374,10259,13572,9694,0,164430,3878
TP.Hồ Chí Minh,2006,231,7426,321702,153521,14739,13684,9759,0,168181,3925
TP.Hồ Chí Minh,2007,231,7603,324267,156129,13454,14232,10077,0,168138,4155
TP.Hồ Chí Minh,2008,239,7679,324605,153331,14347,14436,10279,0,171274,4157
TP.Hồ Chí Minh,2009,241,7557,312581,150584,19709,14439,10517,0,161997,3922
TP.Hồ Chí Minh,2010,245,11899,311096,149543,21065,14302,10436,0,161553,3866
TP.Hồ Chí Minh,2011,255,7925,326435,156847,22502,16081,11656,0,169588,4425
TP.Hồ Chí Minh,2012,252,8043,329415,157295,23204,15955,11606,0,172120,4349
TP.Hồ Chí Minh,2013,255,8478,350807,168129,24180,16681,12066,196,182678,4615
TP.Hồ Chí Minh,2014,259,9052,376713,181580,24725,17246,12453,216,195133,4793
TP.Hồ Chí Minh,2015,260,9281,385062,185687,23934,17393,12580,206,199375,4813
TP.Hồ Chí Minh,2016,266,9652,400502,193255,25612,17548,12627,247,207247,4921
TP.Hồ Chí Minh,2017,271,10021,413270,199804,24649,17794,12864,264,213466,4930
TP.Hồ Chí Minh,2018,273,10295,419450,202501,24918,15121,12667,311,216949,2454
TP.Hồ Chí Minh,2019,275,10715,437975,211380,25058,17056,12470,358,226595,4586
TP.Hồ Chí Minh,2020,277,11166,458698,221560,25495,17330,12673,386,237138,4657
TP.Hồ Chí Minh,2021,279,11046,447940,216003,24555,17293,12640,411,231937,4653
Thanh Hóa,2004,654,9526,367550,188242,64652,16092,10996,1143,179308,5096
Thanh Hóa,2005,652,9206,346251,181684,65741,15551,9905,1008,164567,5646
Thanh Hóa,2006,652,8608,315298,162389,58926,17114,11571,1033,152909,5543
Thanh Hóa,2007,650,7958,277533,144247,74816,16118,10753,1276,133286,5365
Thanh Hóa,2008,649,7272,244224,119716,50171,16059,10432,1176,124508,5627
Thanh Hóa,2009,649,6706,220847,107118,45925,15435,10270,1203,113729,5165
Thanh Hóa,2010,650,6304,197878,105951,46058,15277,10117,1125,91927,5160
Thanh Hóa,2011,650,6193,193078,91270,38572,14390,9350,1127,101808,5040
Thanh Hóa,2012,645,5723,188200,86488,37071,13736,8764,1129,101712,4972
Thanh Hóa,2013,634,5728,180399,87317,35590,14291,9181,1205,93082,5110
Thanh Hóa,2014,633,5735,185439,90854,35829,12826,8461,1133,94585,4365
Thanh Hóa,2015,636,5755,185679,90119,36611,13139,8560,1074,95560,4579
Thanh Hóa,2016,629,5798,184835,89570,36983,12370,7988,1013,95265,4382
Thanh Hóa,2017,619,5730,187862,90564,38018,11494,7382,893,97298,4112
Thanh Hóa,2018,606,5517,187639,90653,39061,11018,7094,888,96986,3924
Thanh Hóa,2019,594,5585,190630,91828,39069,10558,6807,882,98802,3751
Thanh Hóa,2020,561,5789,204597,97889,42047,10407,6877,900,106708,3530
Thanh Hóa,2021,548,5906,210241,100196,44567,10274,6873,888,110045,3401
Thái Bình,2004,276,3604,138992,72309,0,7523,5477,0,66683,2046
Thái Bình,2005,276,3789,128699,62190,0,7212,5866,0,66509,1346
Thái Bình,2006,276,3248,120033,62350,0,7148,5403,0,57683,1745
Thái Bình,2007,274,3177,112063,55040,0,6701,5135,0,57023,1566
Thái Bình,2008,274,3019,103373,50509,0,6629,5085,0,52864,1544
Thái Bình,2009,272,2932,98775,46425,0,6769,5286,0,52350,1483
Thái Bình,2010,270,2934,96778,48047,0,6769,5286,0,48731,1483
Thái Bình,2011,271,2992,98916,48057,0,6912,5509,0,50859,1403
Thái Bình,2012,271,3108,97452,46833,0,6769,5286,0,50619,1483
Thái Bình,2013,271,3072,95769,46006,0,6958,5556,0,49763,1402
Thái Bình,2014,271,2937,97075,46793,0,6791,5421,0,50282,1370
Thái Bình,2015,269,2875,93539,45163,0,6686,5326,0,48376,1360
Thái Bình,2016,267,2847,93803,44743,0,6384,5095,0,49060,1289
Thái Bình,2017,267,2820,96330,46213,0,6174,4924,0,50117,1250
Thái Bình,2018,187,2787,100484,47387,85,4776,4684,0,53097,92
Thái Bình,2019,107,2809,101209,48035,117,5571,4443,0,53174,1128
Thái Bình,2020,106,2839,104912,50098,169,5449,4343,0,54814,1106
Thái Bình,2021,106,2838,104858,50382,212,5401,4320,0,54476,1081
Thái Nguyên,2004,179,2447,90644,43911,26665,4933,3921,967,46733,1012
Thái Nguyên,2005,179,2289,83256,39992,27351,4850,4021,861,43264,829
Thái Nguyên,2006,179,2194,79572,38912,24065,4941,4135,866,40660,806
Thái Nguyên,2007,178,2090,72732,34708,22014,4722,3811,826,38024,911
Thái Nguyên,2008,180,1974,66827,32366,19665,4260,3639,791,34461,621
Thái Nguyên,2009,181,1886,66964,32892,19733,4345,3726,817,34072,619
Thái Nguyên,2010,181,1827,61465,29503,18501,4193,3362,797,31962,831
Thái Nguyên,2011,178,1713,62907,28243,17855,3681,2878,1132,34664,803
Thái Nguyên,2012,181,1754,59043,28338,15942,3879,2292,1466,30705,1587
Thái Nguyên,2013,183,1892,60494,29583,19592,4028,3163,921,30911,865
Thái Nguyên,2014,182,1855,63194,30652,20801,4008,3139,936,32542,869
Thái Nguyên,2015,183,2189,63499,30683,21284,4010,3145,932,32816,865
Thái Nguyên,2016,183,1857,64233,30986,21589,3990,3129,1017,33247,861
Thái Nguyên,2017,184,1897,65936,31907,22517,3918,3074,1027,34029,844
Thái Nguyên,2018,182,1924,68108,33005,23212,3480,2954,972,35103,526
Thái Nguyên,2019,181,2019,71548,34547,24842,3570,2834,918,37001,736
Thái Nguyên,2020,179,2127,76646,36831,27237,3503,2789,877,39815,714
Thái Nguyên,2021,179,2203,80488,38437,29376,3399,2729,862,42051,670
Thừa Thiên Huế,2004,94,2408,98250,46253,3728,4040,2385,30,51997,1655
Thừa Thiên Huế,2005,99,2475,99301,47337,3638,4312,2525,36,51964,1787
Thừa Thiên Huế,2006,104,2484,98754,47276,3854,4578,2704,29,51478,1874
Thừa Thiên Huế,2007,103,2477,94018,46768,3902,4753,2812,20,47250,1941
Thừa Thiên Huế,2008,105,2423,90249,42513,3812,4711,2757,33,47736,1954
Thừa Thiên Huế,2009,111,2395,84654,41400,3713,4785,2816,40,43254,1969
Thừa Thiên Huế,2010,115,2365,79431,39160,3539,4797,2836,24,40271,1961
Thừa Thiên Huế,2011,117,2331,76447,38893,3509,4468,2593,35,37554,1875
Thừa Thiên Huế,2012,120,2301,74495,35879,3547,4938,2904,46,38616,2034
Thừa Thiên Huế,2013,120,2247,73194,34516,3576,4808,2870,59,38678,1938
Thừa Thiên Huế,2014,119,2105,71851,34252,3514,4615,2737,57,37599,1878
Thừa Thiên Huế,2015,119,2037,70367,34080,3541,4450,2617,57,36287,1833
Thừa Thiên Huế,2016,120,1993,69110,33838,3596,4324,2544,54,35272,1780
Thừa Thiên Huế,2017,120,1982,68338,33627,3568,4259,2557,58,34711,1702
Thừa Thiên Huế,2018,118,1963,67302,33131,3262,3939,2434,52,34171,1505
Thừa Thiên Huế,2019,117,1946,67089,33218,3214,3793,2312,47,33871,1481
Thừa Thiên Huế,2020,112,1938,68205,33226,3054,3811,2360,56,34979,1451
Thừa Thiên Huế,2021,109,1862,64423,31285,2355,3732,2349,41,33138,1383
Tiền Giang,2004,118,2800,112973,55561,0,4949,3178,0,57412,1771
Tiền Giang,2005,118,2694,106965,52587,0,5132,3291,0,54378,1841
Tiền Giang,2006,119,2641,105260,52219,0,5014,3257,0,53041,1757
Tiền Giang,2007,120,2563,100104,49084,0,4934,3237,0,51020,1697
Tiền Giang,2008,120,2550,99315,49141,0,4995,3271,0,50174,1724
Tiền Giang,2009,124,2427,94096,46124,0,5007,3118,0,47972,1889
Tiền Giang,2010,124,2424,92429,46295,0,4909,3151,0,46134,1758
Tiền Giang,2011,125,2414,94068,47119,0,4852,3162,0,46949,1690
Tiền Giang,2012,125,2437,93698,46845,0,4840,3116,0,46853,1724
Tiền Giang,2013,125,2502,97404,48575,0,4789,3065,0,48829,1724
Tiền Giang,2014,125,2595,102399,50855,0,4913,3098,0,51544,1815
Tiền Giang,2015,125,2597,102056,50790,0,4992,3116,0,51266,1876
Tiền Giang,2016,126,2524,101925,50858,0,4883,3031,0,51067,1852
Tiền Giang,2017,126,2510,102748,51111,0,4877,3008,0,51637,1869
Tiền Giang,2018,122,2460,69914,49633,168,4794,2920,0,20281,1874
Tiền Giang,2019,118,2451,100511,49578,196,4661,2831,0,50933,1830
Tiền Giang,2020,111,2518,104579,51381,182,4572,2744,0,53198,1828
Tiền Giang,2021,109,2413,98491,48392,208,4385,2609,0,50099,1776
Trà Vinh,2004,86,1820,73049,34735,22364,3876,1950,557,38314,1926
Trà Vinh,2005,89,1672,61398,29318,17862,3834,1976,592,32080,1858
Trà Vinh,2006,91,1548,55699,26814,15661,3564,1910,512,28885,1654
Trà Vinh,2007,92,1473,50942,24654,13758,3486,1883,505,26288,1603
Trà Vinh,2008,94,1453,50373,24187,14038,3513,1883,522,26186,1630
Trà Vinh,2009,94,1478,47877,23607,13400,3437,1894,506,24270,1543
Trà Vinh,2010,96,1507,48344,24004,14040,3525,1911,528,24340,1614
Trà Vinh,2011,97,1535,51169,25365,15262,3490,1902,541,25804,1588
Trà Vinh,2012,98,1596,51544,25463,15532,3518,1873,554,26081,1645
Trà Vinh,2013,99,1610,53402,26418,16146,3442,1852,541,26984,1590
Trà Vinh,2014,99,1630,55420,27416,16552,3488,1881,545,28004,1607
Trà Vinh,2015,100,1674,55472,27493,16784,3515,1920,537,27979,1595
Trà Vinh,2016,100,1669,55287,27595,16798,3555,1941,568,27692,1614
Trà Vinh,2017,101,1645,55973,28023,17245,3564,1941,581,27950,1623
Trà Vinh,2018,100,1576,57400,27776,17673,3480,1896,576,29624,1584
Trà Vinh,2019,99,1599,56136,27938,18438,3413,1852,570,28198,1561
Trà Vinh,2020,96,1626,58473,28998,19639,3370,1823,578,29475,1547
Trà Vinh,2021,96,1621,58241,28764,20173,3315,1793,583,29477,1522
Tuyên Quang,2004,140,1973,71718,34168,41126,3464,2625,740,37550,839
Tuyên Quang,2005,153,1979,66947,32095,38449,3482,2533,1070,34852,949
Tuyên Quang,2006,151,1801,61490,29614,36388,3390,2504,806,31876,886
Tuyên Quang,2007,149,1623,53536,26605,31663,3294,2304,791,26931,990
Tuyên Quang,2008,142,1502,48403,23391,28537,3035,2245,1042,25012,790
Tuyên Quang,2009,141,1450,45879,22117,26781,3097,2241,839,23762,856
Tuyên Quang,2010,142,1386,42857,20992,25348,3011,2167,833,21865,844
Tuyên Quang,2011,143,1339,42184,20174,25539,2566,1843,808,22010,723
Tuyên Quang,2012,142,1337,42018,20354,25481,2922,1986,783,21664,936
Tuyên Quang,2013,142,1341,42068,20485,25795,2880,2026,816,21583,854
Tuyên Quang,2014,141,1361,43879,21294,26792,2826,1998,850,22585,828
Tuyên Quang,2015,138,1370,44593,21798,27770,2837,2022,832,22795,815
Tuyên Quang,2016,136,1359,44882,21767,27999,2831,2010,852,23115,821
Tuyên Quang,2017,136,1344,45947,22398,28943,2717,1929,863,23549,788
Tuyên Quang,2018,136,1383,47044,22845,29070,2087,1826,807,24199,261
Tuyên Quang,2019,135,1405,49232,23791,30785,2438,1724,751,25441,714
Tuyên Quang,2020,132,1453,52499,25676,33039,2493,1785,814,26823,708
Tuyên Quang,2021,119,1445,53199,25657,34875,2333,1639,801,27542,694
Tây Ninh,2004,99,1914,73920,36032,616,3495,2409,0,37888,1086
Tây Ninh,2005,101,1798,69439,34518,791,3543,2432,0,34921,1111
Tây Ninh,2006,103,1750,67247,33439,739,3563,2452,0,33808,1111
Tây Ninh,2007,103,1619,63550,31839,668,3497,2424,0,31711,1073
Tây Ninh,2008,106,1569,61893,31135,680,3486,2423,0,30758,1063
Tây Ninh,2009,106,1557,58874,29574,560,3451,2396,0,29300,1055
Tây Ninh,2010,106,1515,56872,28455,556,3372,2358,0,28417,1014
Tây Ninh,2011,106,1531,57899,28850,685,3313,2304,0,29049,1009
Tây Ninh,2012,106,1521,56841,28250,364,3253,2275,0,28591,978
Tây Ninh,2013,106,1583,59665,29508,807,3286,2283,0,30157,1003
Tây Ninh,2014,106,1809,59881,29027,871,3255,2269,0,30854,986
Tây Ninh,2015,106,1618,62008,30564,942,3352,2319,0,31444,1033
Tây Ninh,2016,106,1643,63245,31209,1039,3319,2297,0,32036,1022
Tây Ninh,2017,105,1666,64907,32080,1079,3281,2279,0,32827,1002
Tây Ninh,2018,104,1652,65047,32038,1053,3304,2224,0,33009,1080
Tây Ninh,2019,102,1652,67294,33220,1173,3163,2170,0,34074,993
Tây Ninh,2020,99,1689,69556,34237,1243,3010,2063,0,35319,947
Tây Ninh,2021,98,1678,68013,33455,1337,2914,1983,0,34558,931
Vĩnh Long,2004,88,2158,77945,37450,1784,3469,2023,0,40495,1446
Vĩnh Long,2005,91,1877,69508,34361,1927,3420,2003,0,35147,1417
Vĩnh Long,2006,91,1834,65945,32120,1481,3548,2075,0,33825,1473
Vĩnh Long,2007,92,1776,62103,24947,1329,3569,2127,0,37156,1442
Vĩnh Long,2008,93,1752,60245,29723,1269,3587,2205,0,30522,1382
Vĩnh Long,2009,93,1673,56202,28217,1208,3574,2175,0,27985,1399
Vĩnh Long,2010,92,1628,54451,27053,1114,3538,2133,0,27398,1405
Vĩnh Long,2011,92,1635,55143,26489,1161,3530,2121,0,28654,1409
Vĩnh Long,2012,91,1645,54386,26893,1212,3537,2151,0,27493,1386
Vĩnh Long,2013,89,1702,57001,28147,1294,3512,2076,0,28854,1436
Vĩnh Long,2014,88,1759,59399,29322,1342,3515,2093,0,30077,1422
Vĩnh Long,2015,88,1762,58728,28538,1249,3505,2092,0,30190,1413
Vĩnh Long,2016,88,1768,58175,28063,1203,3488,2064,0,30112,1424
Vĩnh Long,2017,89,1898,58722,28727,1342,3407,2018,26,29995,1389
Vĩnh Long,2018,89,1694,97783,28130,1490,3343,1962,36,69653,1381
Vĩnh Long,2019,89,1725,59131,28904,1627,3237,1906,46,30227,1331
Vĩnh Long,2020,87,1740,61618,30090,1661,3108,1854,47,31528,1254
Vĩnh Long,2021,87,1712,59817,29275,1752,3094,1846,49,30542,1248
Vĩnh Phúc,2004,155,2625,100057,50528,4393,5232,3434,0,49529,1798
Vĩnh Phúc,2005,158,2523,94542,45226,3936,5268,3384,0,49316,1884
Vĩnh Phúc,2006,162,2436,88776,43465,4203,5046,3484,0,45311,1562
Vĩnh Phúc,2007,167,2391,83471,40781,4040,5255,3544,0,42690,1711
Vĩnh Phúc,2008,144,1958,64519,31386,3653,4370,2968,0,33133,1402
Vĩnh Phúc,2009,145,1895,60367,29736,3339,4431,3054,0,30631,1377
Vĩnh Phúc,2010,145,1847,56496,27095,3305,4274,2891,0,29401,1383
Vĩnh Phúc,2011,145,1829,55713,27193,3252,4260,2961,0,28520,1299
Vĩnh Phúc,2012,146,1808,54959,26444,3215,4131,2834,0,28515,1297
Vĩnh Phúc,2013,146,1797,54844,26702,3151,4204,2948,53,28142,1256
Vĩnh Phúc,2014,146,1816,57543,28099,3187,4133,2878,50,29444,1255
Vĩnh Phúc,2015,146,1708,58576,27942,3206,4081,2880,57,30634,1201
Vĩnh Phúc,2016,146,1785,62093,29952,3259,3832,2669,60,32141,1163
Vĩnh Phúc,2017,147,1793,66289,31851,3525,3754,2640,52,34438,1114
Vĩnh Phúc,2018,141,1837,71238,34089,3710,3486,2574,64,37149,912
Vĩnh Phúc,2019,135,1938,74645,35368,3808,3549,2508,75,39277,1041
Vĩnh Phúc,2020,132,2032,79210,37370,4076,3562,2551,77,41840,1011
Vĩnh Phúc,2021,132,2102,82458,38608,4544,3531,2520,81,43850,1011
Yên Bái,2004,116,1856,65194,29711,34283,3471,2637,662,35483,834
Yên Bái,2005,126,1915,63385,28953,34938,3514,2658,675,34432,856
Yên Bái,2006,131,1861,61432,28359,35041,3532,2638,696,33073,894
Yên Bái,2007,134,1763,56751,26621,32944,3496,2582,719,30130,914
Yên Bái,2008,141,1703,51409,24206,29960,3385,2439,676,27203,946
Yên Bái,2009,147,1552,48255,22571,28642,3421,2407,784,25684,1014
Yên Bái,2010,148,1472,44781,21151,26925,3298,2279,813,23630,1019
Yên Bái,2011,149,1474,44531,21109,26597,3312,2474,824,23422,838
Yên Bái,2012,150,1455,45285,21603,27380,3289,2245,834,23682,1044
Yên Bái,2013,150,1465,46495,22006,28329,3194,2180,827,24489,1014
Yên Bái,2014,149,1504,48853,23071,29663,3160,2165,848,25782,995
Yên Bái,2015,146,1517,50425,23906,30928,3082,2116,822,26519,966
Yên Bái,2016,53,1512,51706,24475,32184,3014,2054,799,27231,960
Yên Bái,2017,53,1542,53015,25262,33237,2886,1953,763,27753,933
Yên Bái,2018,53,1540,54239,26234,34315,2940,1942,750,28005,998
Yên Bái,2019,53,1547,55264,26666,34918,2812,1931,736,28598,881
Yên Bái,2020,54,1580,57641,27845,36580,2715,1854,718,29796,861
Yên Bái,2021,53,1594,59239,28627,38088,2629,1797,692,30612,832
Điện Biên,2004,66,1089,30410,11014,23419,2036,1302,301,19396,734
Điện Biên,2005,97,1101,32653,13714,27755,2224,1417,301,18939,807
Điện Biên,2006,99,1169,33210,12801,26937,2363,1498,325,20409,865
Điện Biên,2007,111,1192,34467,13561,28697,2498,1596,455,20906,902
Điện Biên,2008,112,1151,36169,14376,29569,2796,1635,536,21793,1161
Điện Biên,2009,110,1323,37359,15254,32120,2799,1629,627,22105,1170
Điện Biên,2010,115,1285,36808,14866,31138,2897,1687,647,21942,1210
Điện Biên,2011,111,1303,36424,15224,31579,2645,1532,738,21200,1113
Điện Biên,2012,110,1283,36398,15573,31584,2989,1610,828,20825,1379
Điện Biên,2013,110,1276,37087,16053,32242,2669,1523,769,21034,1146
Điện Biên,2014,110,1322,39754,17534,34604,2609,1537,774,22220,1072
Điện Biên,2015,114,1319,40530,18237,35921,2587,1546,737,22293,1041
Điện Biên,2016,124,1383,42785,19325,37342,2742,1602,850,23460,1140
Điện Biên,2017,128,1400,44279,20128,38503,2752,1598,875,24151,1154
Điện Biên,2018,120,1370,45135,20733,39236,2809,1578,908,24402,1231
Điện Biên,2019,112,1385,46237,21545,39922,2724,1558,942,24692,1166
Điện Biên,2020,98,1399,47522,22176,40965,2758,1575,982,25346,1183
Điện Biên,2021,96,1417,48679,22849,41798,2713,1545,997,25830,1168
Đà Nẵng,2004,48,1440,61357,29360,0,2781,2060,0,31997,721
Đà Nẵng,2005,48,1449,61417,29385,0,2834,2101,0,32032,733
Đà Nẵng,2006,49,1451,61016,29382,2062,2797,2072,0,31634,725
Đà Nẵng,2007,50,1456,59153,27641,0,2852,2092,0,31512,760
Đà Nẵng,2008,50,1428,56403,27468,0,2840,2139,0,28935,701
Đà Nẵng,2009,51,1367,52159,25203,0,2828,2131,0,26956,697
Đà Nẵng,2010,53,1332,48764,23518,0,2765,2046,0,25246,719
Đà Nẵng,2011,54,1310,47745,22971,0,2754,2107,0,24774,647
Đà Nẵng,2012,54,1260,46718,22526,0,2813,2133,0,24192,680
Đà Nẵng,2013,55,1294,48661,23514,0,2721,2016,0,25147,705
Đà Nẵng,2014,55,1370,51517,24710,0,2775,2107,0,26807,668
Đà Nẵng,2015,56,1393,53845,25672,0,2774,2091,0,28173,683
Đà Nẵng,2016,57,1450,57109,27461,0,2792,2134,0,29648,658
Đà Nẵng,2017,56,1507,60261,29016,0,2942,2297,0,31245,645
Đà Nẵng,2018,56,1566,62386,30280,153,2659,2362,0,32106,297
Đà Nẵng,2019,57,1651,65192,31459,225,3011,2427,0,33733,584
Đà Nẵng,2020,57,1713,69379,33507,246,2959,2416,0,35872,543
Đà Nẵng,2021,57,1684,66952,32153,223,3074,2527,0,34799,547
Đắk Lắk,2004,174,3964,168218,82623,46162,6424,4130,326,85595,2294
Đắk Lắk,2005,180,4073,165550,81726,47725,6564,4134,288,83824,2430
Đắk Lắk,2006,198,4131,166835,83359,50344,6757,4329,301,83476,2428
Đắk Lắk,2007,203,4065,161283,80527,48486,7253,4704,370,80756,2549
Đắk Lắk,2008,213,3986,152694,77402,47677,7439,4806,421,75292,2633
Đắk Lắk,2009,214,3887,145784,73750,45242,7546,4910,462,72034,2636
Đắk Lắk,2010,214,3795,139854,69475,38702,7672,5042,479,70379,2630
Đắk Lắk,2011,221,3749,139844,68832,44665,7560,4642,488,71012,2918
Đắk Lắk,2012,223,3721,131886,66427,42813,7751,4977,498,65459,2774
Đắk Lắk,2013,226,3717,128138,62511,38582,8022,5092,400,65627,2930
Đắk Lắk,2014,226,4221,124657,62479,42070,7887,5188,560,62178,2699
Đắk Lắk,2015,226,3692,119957,60464,41227,7898,5197,576,59493,2701
Đắk Lắk,2016,227,3725,117984,59505,41201,7944,5222,590,58479,2722
Đắk Lắk,2017,227,3666,118779,59762,40579,7828,5135,569,59017,2693
Đắk Lắk,2018,227,3626,119696,59858,41025,7141,4920,564,59838,2221
Đắk Lắk,2019,227,3625,123396,61317,42622,7164,4704,558,62079,2460
Đắk Lắk,2020,224,3654,128497,63914,44348,7054,4630,557,64583,2424
Đắk Lắk,2021,222,3633,127946,63772,46013,6944,4568,540,64174,2376
Đắk Nông,2004,50,870,33497,15997,8208,1359,762,51,17500,597
Đắk Nông,2005,57,937,22873,16902,4358,1640,907,45,5971,733
Đắk Nông,2006,59,1012,35602,15491,5681,1563,918,49,20111,645
Đắk Nông,2007,62,1105,38844,17954,11213,1814,954,73,20890,860
Đắk Nông,2008,73,1115,38465,19023,11349,1969,1151,102,19442,818
Đắk Nông,2009,78,1079,37212,18276,11127,2014,1229,114,18936,785
Đắk Nông,2010,81,1078,37663,18797,11356,2123,1349,139,18866,774
Đắk Nông,2011,82,1349,38830,19227,11827,2189,1368,154,19603,821
Đắk Nông,2012,84,1122,39283,19425,12022,2232,1400,168,19858,832
Đắk Nông,2013,78,1120,38934,19385,12367,2245,1423,179,19549,822
Đắk Nông,2014,77,1164,40023,19940,12514,2302,1480,181,20083,822
Đắk Nông,2015,76,1166,39693,19754,12562,2318,1488,198,19939,830
Đắk Nông,2016,76,1170,40307,20199,13040,2296,1475,201,20108,821
Đắk Nông,2017,76,1187,40852,20460,12976,2233,1450,186,20392,783
Đắk Nông,2018,74,1176,42970,21248,13737,2306,1440,194,21722,866
Đắk Nông,2019,72,1173,44525,21873,14313,2196,1431,202,22652,765
Đắk Nông,2020,64,1224,47035,23064,14665,2262,1483,211,23971,779
Đắk Nông,2021,63,1234,47398,22962,14957,2189,1432,201,24436,757
Đồng Nai,2004,145,4191,179249,88697,6156,6342,4444,0,90552,1898
Đồng Nai,2005,149,4218,178844,89422,6190,7014,4467,0,89422,2547
Đồng Nai,2006,157,4150,174798,89147,5827,6793,4828,41,85651,1965
Đồng Nai,2007,163,4156,168220,81091,5631,7080,5043,48,87129,2037
Đồng Nai,2008,166,4043,161102,78946,5026,7394,5267,57,82156,2127
Đồng Nai,2009,166,3873,153286,74441,5192,7843,5674,183,78845,2169
Đồng Nai,2010,165,3904,146117,71013,4822,7504,5712,86,75104,1792
Đồng Nai,2011,167,3888,146533,71460,5721,7513,5465,76,75073,2048
Đồng Nai,2012,169,3778,145836,71340,6994,7582,5591,66,74496,1991
Đồng Nai,2013,168,3964,151073,73907,8719,7697,5637,94,77166,2060
Đồng Nai,2014,170,4097,157586,76865,9245,7826,5753,100,80721,2073
Đồng Nai,2015,172,4118,158974,77724,9545,7959,5820,99,81250,2139
Đồng Nai,2016,172,4206,162811,79485,9663,7982,5851,102,83326,2131
Đồng Nai,2017,174,4343,168444,82249,9953,8051,5905,100,86195,2146
Đồng Nai,2018,171,4358,171690,83677,10444,8145,5936,116,88013,2209
Đồng Nai,2019,168,4552,184076,88949,11238,8078,5966,133,95127,2112
Đồng Nai,2020,170,4740,194916,94149,11966,8157,6043,140,100767,2114
Đồng Nai,2021,169,4754,195040,94362,11906,8256,6117,147,100678,2139
Đồng Tháp,2004,123,3008,123403,58917,0,4769,2555,0,64486,2214
Đồng Tháp,2005,126,2844,114762,54912,0,4974,2678,0,59850,2296
Đồng Tháp,2006,133,2607,105128,50674,0,5053,2713,0,54454,2340
Đồng Tháp,2007,133,2490,96666,48469,0,5050,2784,0,48197,2266
Đồng Tháp,2008,137,2440,93516,45777,0,5021,2839,0,47739,2182
Đồng Tháp,2009,137,2360,88726,43237,0,5076,2839,0,45489,2237
Đồng Tháp,2010,130,2408,87903,43160,0,5122,2870,0,44743,2252
Đồng Tháp,2011,130,2451,89827,44356,0,5423,3690,0,45471,1733
Đồng Tháp,2012,129,2439,89061,43783,0,5012,2846,0,45278,2166
Đồng Tháp,2013,129,2505,92010,45347,0,5016,2829,0,46663,2187
Đồng Tháp,2014,129,2508,94472,46389,0,5023,2828,0,48083,2195
Đồng Tháp,2015,129,2526,94497,46312,0,4974,2787,0,48185,2187
Đồng Tháp,2016,128,2531,96416,47165,0,4971,2775,0,49251,2196
Đồng Tháp,2017,127,2556,98688,48506,0,5006,2771,0,50182,2235
Đồng Tháp,2018,126,2543,124600,48333,69,4990,2706,0,76267,2284
Đồng Tháp,2019,124,2553,99803,49409,57,4789,2640,0,50394,2149
Đồng Tháp,2020,122,2628,104483,51090,94,4738,2613,0,53393,2125
Đồng Tháp,2021,122,2564,99452,48568,98,4608,2585,0,50884,2023
