Địa phương,Năm,Lớp,Trường,Học sinh,Học sinh nữ,Học sinh dân tộc thiểu số,Giáo viên,Giáo viên nữ,Giáo viên dân tộc thiểu số,Học sinh nam,Giáo viên nam
An Giang,2004,1056,56,48155,22983,1406,1794,764,39,25172,1030
An Giang,2005,1112,55,48697,23419,1670,2062,953,44,25278,1109
An Giang,2006,1125,53,45929,21894,1627,2316,1017,69,24035,1299
An Giang,2007,1577,52,43531,22567,1291,2452,1158,17,20964,1294
An Giang,2008,1056,48,42409,22454,789,2553,1195,27,19955,1358
An Giang,2009,1096,47,41748,22186,1160,2791,1327,57,19562,1464
An Giang,2010,1120,47,41882,22898,1184,2894,1450,59,18984,1444
An Giang,2011,1188,44,43580,23744,1190,2957,1509,60,19836,1448
An Giang,2012,1239,44,45686,24653,702,2901,1482,61,21033,1419
An Giang,2013,1218,43,44006,23321,1353,3045,1554,65,20685,1491
An Giang,2014,1213,42,43195,22852,1576,3014,1551,67,20343,1463
An Giang,2015,1221,42,43040,23237,1620,2992,1539,67,19803,1453
An Giang,2016,1262,42,45393,24728,1694,2877,1462,57,20665,1415
An Giang,2017,1269,42,46222,25012,1649,2963,1519,52,21210,1444
An Giang,2018,1239,42,36691,24973,1566,2863,1522,55,11718,1341
An Giang,2019,1261,43,49558,26569,1667,2931,1525,58,22989,1406
An Giang,2020,1302,43,53061,29048,1875,2954,1546,57,24013,1408
An Giang,2021,1333,43,55498,30270,2074,2939,1551,55,25228,1388
Bà Rịa - Vũng Tàu,2004,753,21,33445,17197,326,1338,1200,0,16248,138
Bà Rịa - Vũng Tàu,2005,836,22,36365,18732,371,1552,977,0,17633,575
Bà Rịa - Vũng Tàu,2006,875,24,37721,18614,444,1600,975,0,19107,625
Bà Rịa - Vũng Tàu,2007,891,25,37568,19953,416,1718,1049,0,17615,669
Bà Rịa - Vũng Tàu,2008,889,25,36578,20306,380,1872,1164,0,16272,708
Bà Rịa - Vũng Tàu,2009,882,25,34678,19575,489,2202,1182,0,15103,1020
Bà Rịa - Vũng Tàu,2010,947,27,35021,19913,595,2020,1259,0,15108,761
Bà Rịa - Vũng Tàu,2011,902,27,34054,19205,554,2068,1289,0,14849,779
Bà Rịa - Vũng Tàu,2012,966,29,35197,19300,579,2043,1309,0,15897,734
Bà Rịa - Vũng Tàu,2013,936,29,31905,17329,537,2136,1376,0,14576,760
Bà Rịa - Vũng Tàu,2014,940,28,30865,17107,677,2127,1375,0,13758,752
Bà Rịa - Vũng Tàu,2015,947,29,30840,17239,662,2094,1326,0,13601,768
Bà Rịa - Vũng Tàu,2016,954,29,31562,17626,686,2093,1326,0,13936,767
Bà Rịa - Vũng Tàu,2017,956,29,32136,17906,674,2082,1320,17,14230,762
Bà Rịa - Vũng Tàu,2018,952,30,34276,19076,664,2066,1314,18,15200,752
Bà Rịa - Vũng Tàu,2019,948,30,34107,18892,765,2003,1307,20,15215,696
Bà Rịa - Vũng Tàu,2020,964,31,35426,19562,782,2055,1352,18,15864,703
Bà Rịa - Vũng Tàu,2021,954,31,35562,19419,765,2110,1399,30,16143,711
Bình Dương,2004,622,4,26432,14435,0,1012,604,0,11997,408
Bình Dương,2005,678,11,28376,15472,0,1145,666,0,12904,479
Bình Dương,2006,686,12,28069,13803,206,1254,725,0,14266,529
Bình Dương,2007,649,14,25265,14428,76,1340,793,0,10837,547
Bình Dương,2008,618,14,22483,13208,37,1402,841,0,9275,561
Bình Dương,2009,610,14,21439,12464,169,1427,847,0,8975,580
Bình Dương,2010,623,17,21905,12507,181,1508,876,0,9398,632
Bình Dương,2011,647,21,21052,12024,86,1534,904,0,9028,630
Bình Dương,2012,648,21,21558,12539,97,1651,1011,0,9019,640
Bình Dương,2013,704,22,22415,12324,185,1692,749,0,10091,943
Bình Dương,2014,739,23,24055,13197,194,1777,1069,0,10858,708
Bình Dương,2015,772,24,25716,14026,314,1779,1114,0,11690,665
Bình Dương,2016,835,24,27882,15668,251,1896,1172,0,12214,724
Bình Dương,2017,851,24,28792,16144,338,1964,1206,0,12648,758
Bình Dương,2018,856,24,30731,17297,455,1854,1198,0,13434,656
Bình Dương,2019,878,23,31829,17978,503,1858,1189,0,13851,669
Bình Dương,2020,907,24,33705,18924,633,1880,1197,0,14781,683
Bình Dương,2021,943,26,34896,19429,785,1884,1210,0,15467,674
Bình Phước,2004,545,16,19056,10071,1296,679,359,16,8985,320
Bình Phước,2005,645,16,26461,12722,1882,1027,647,13,13739,380
Bình Phước,2006,669,17,27322,13494,2274,1108,584,12,13828,524
Bình Phước,2007,694,20,27239,14980,2085,1522,809,27,12259,713
Bình Phước,2008,700,21,27103,15030,2137,1575,859,36,12073,716
Bình Phước,2009,741,21,27351,14170,2166,1610,800,40,13181,810
Bình Phước,2010,743,21,27841,15324,2866,1759,1013,48,12517,746
Bình Phước,2011,775,23,28245,15365,3259,1834,1075,48,12880,759
Bình Phước,2012,800,24,27781,15187,3213,1907,1121,47,12594,786
Bình Phước,2013,799,25,26770,14558,3393,1931,1143,67,12212,788
Bình Phước,2014,815,26,26316,14211,3216,2009,1199,74,12105,810
Bình Phước,2015,833,26,26885,14529,3324,2012,1207,76,12356,805
Bình Phước,2016,840,27,27982,15326,3238,2063,1228,70,12656,835
Bình Phước,2017,850,27,28785,15899,3363,2040,1206,70,12886,834
Bình Phước,2018,868,27,28881,15868,3242,2096,1228,76,13013,868
Bình Phước,2019,857,27,29605,16272,3470,2099,1251,82,13333,848
Bình Phước,2020,861,27,31095,16914,3629,2056,1229,83,14181,827
Bình Phước,2021,882,27,32316,17456,4021,1936,1181,78,14860,755
Bình Thuận,2004,790,20,35985,19067,1533,1258,684,47,16918,574
Bình Thuận,2005,918,24,40728,21953,1740,1398,760,62,18775,638
Bình Thuận,2006,964,26,42270,21092,1922,1526,831,66,21178,695
Bình Thuận,2007,975,27,42982,23967,1984,1657,916,83,19015,741
Bình Thuận,2008,1000,25,44454,25033,2161,1744,975,94,19421,769
Bình Thuận,2009,1019,26,44843,25573,2273,1818,1031,115,19270,787
Bình Thuận,2010,1030,26,44701,26203,2409,2032,1175,130,18498,857
Bình Thuận,2011,1018,26,44433,25950,2732,2242,1334,144,18483,908
Bình Thuận,2012,1091,27,43665,25189,2695,2605,1541,158,18476,1064
Bình Thuận,2013,1068,26,39074,22486,2613,2526,1500,166,16588,1026
Bình Thuận,2014,979,26,35737,20595,2232,2499,1496,169,15142,1003
Bình Thuận,2015,949,25,34089,19709,2185,2454,1473,169,14380,981
Bình Thuận,2016,938,25,33714,19565,2048,2388,1434,164,14149,954
Bình Thuận,2017,935,25,33387,19440,2012,2352,1412,161,13947,940
Bình Thuận,2018,939,25,33712,19509,2013,2293,1390,164,14203,903
Bình Thuận,2019,908,25,35333,20422,2000,2258,1368,166,14911,890
Bình Thuận,2020,940,25,37197,21277,2108,2213,1353,160,15920,860
Bình Thuận,2021,951,25,38160,21668,2235,2206,1345,159,16492,861
Bình Định,2004,1151,29,53696,25152,562,1623,781,0,28544,842
Bình Định,2005,1253,31,57410,28360,643,1734,853,0,29050,881
Bình Định,2006,1349,32,63213,30694,869,1845,877,0,32519,968
Bình Định,2007,1464,40,69407,35231,945,2109,1026,0,34176,1083
Bình Định,2008,1571,39,74793,38183,1063,2330,1185,0,36610,1145
Bình Định,2009,1567,45,75461,39530,1111,2409,1216,0,35931,1193
Bình Định,2010,1561,47,73563,39694,1120,2542,1311,0,33869,1231
Bình Định,2011,1518,47,71050,36920,1589,2498,1293,0,34130,1205
Bình Định,2012,1516,47,67540,35926,1218,2682,1329,0,31614,1353
Bình Định,2013,1423,48,61117,31580,1146,2696,1372,59,29537,1324
Bình Định,2014,1351,50,55825,30105,1186,2654,1426,23,25720,1228
Bình Định,2015,1322,50,52764,28779,1103,2691,1464,24,23985,1227
Bình Định,2016,1341,50,53558,29288,1142,2702,1476,28,24270,1226
Bình Định,2017,1342,50,52685,28811,1096,2675,1439,27,23874,1236
Bình Định,2018,1321,50,52172,28634,1107,2574,1392,28,23538,1182
Bình Định,2019,1332,50,52832,28819,1201,2452,1344,29,24013,1108
Bình Định,2020,1322,50,54087,29586,1275,2395,1317,29,24501,1078
Bình Định,2021,1336,51,54676,29724,1351,2477,1390,29,24952,1087
Bạc Liêu,2004,412,9,17365,6905,964,509,208,10,10460,301
Bạc Liêu,2005,448,9,18772,8439,899,770,327,27,10333,443
Bạc Liêu,2006,458,11,19281,8854,1021,966,405,32,10427,561
Bạc Liêu,2007,452,11,18420,8700,979,874,394,39,9720,480
Bạc Liêu,2008,428,11,16926,8263,869,917,414,40,8663,503
Bạc Liêu,2009,401,11,15329,7766,760,868,395,40,7563,473
Bạc Liêu,2010,386,12,14650,7628,699,856,396,45,7022,460
Bạc Liêu,2011,389,12,15211,7779,791,835,388,44,7432,447
Bạc Liêu,2012,378,12,15124,7793,810,862,394,44,7331,468
Bạc Liêu,2013,356,15,14333,7222,760,829,399,42,7111,430
Bạc Liêu,2014,353,14,14175,7154,759,818,388,42,7021,430
Bạc Liêu,2015,370,14,14674,7510,815,826,386,43,7164,440
Bạc Liêu,2016,389,14,15705,8130,1117,815,391,48,7575,424
Bạc Liêu,2017,403,15,16324,8457,1224,814,387,53,7867,427
Bạc Liêu,2018,410,15,31954,8789,1197,783,380,60,23165,403
Bạc Liêu,2019,421,15,17534,9204,1307,780,372,66,8330,408
Bạc Liêu,2020,439,14,18157,9466,1414,777,378,68,8691,399
Bạc Liêu,2021,439,14,18204,9412,1511,769,383,71,8792,386
Bắc Giang,2004,1293,41,63120,28136,5321,2375,1188,71,34984,1187
Bắc Giang,2005,1364,43,69627,32308,6016,2467,1247,79,37319,1220
Bắc Giang,2006,1478,46,72320,36021,6720,2552,1595,79,36299,957
Bắc Giang,2007,1578,47,67297,32759,5867,2635,1452,85,34538,1183
Bắc Giang,2008,1383,46,60231,30822,6267,2772,1499,119,29409,1273
Bắc Giang,2009,1345,49,56306,28831,5762,2673,1571,113,27475,1102
Bắc Giang,2010,1239,48,55463,31184,6837,2798,1786,171,24279,1012
Bắc Giang,2011,1228,48,53554,30250,6789,2723,1739,190,23304,984
Bắc Giang,2012,1229,48,51633,28244,6698,2846,1859,210,23389,987
Bắc Giang,2013,1210,48,50176,28170,7047,2797,1851,242,22006,946
Bắc Giang,2014,1204,45,48748,27307,7146,2711,1785,219,21441,926
Bắc Giang,2015,1203,43,49193,27646,7323,2668,1782,223,21547,886
Bắc Giang,2016,1213,43,49868,27843,7493,2783,1887,261,22025,896
Bắc Giang,2017,1222,43,50667,27973,7675,2746,1877,248,22694,869
Bắc Giang,2018,1238,44,51101,27911,7946,2668,1890,276,23190,778
Bắc Giang,2019,1249,44,51661,10550,9363,2732,1903,304,41111,829
Bắc Giang,2020,1273,44,52736,28037,8044,2726,1923,308,24699,803
Bắc Giang,2021,1286,44,53535,28303,8256,2766,1945,319,25232,821
Bắc Kạn,2004,278,8,13429,7029,11641,413,266,285,6400,147
Bắc Kạn,2005,296,8,13538,7212,11616,480,316,308,6326,164
Bắc Kạn,2006,303,9,13032,5994,11265,493,325,308,7038,168
Bắc Kạn,2007,289,9,11233,5577,9711,474,261,292,5656,213
Bắc Kạn,2008,247,9,10318,5055,7841,610,371,450,5263,239
Bắc Kạn,2009,263,9,10090,5855,9749,636,436,429,4235,200
Bắc Kạn,2010,291,10,9994,5609,8874,594,404,420,4385,190
Bắc Kạn,2011,255,11,9773,5284,8792,579,396,450,4489,183
Bắc Kạn,2012,248,11,8789,4777,7803,573,387,480,4012,186
Bắc Kạn,2013,244,11,8166,4407,7343,557,381,401,3759,176
Bắc Kạn,2014,239,11,7920,4214,7155,537,366,399,3706,171
Bắc Kạn,2015,239,11,7960,4177,7185,500,343,379,3783,157
Bắc Kạn,2016,218,11,7889,4102,6767,525,361,359,3787,164
Bắc Kạn,2017,217,11,7776,4020,6947,517,353,390,3756,164
Bắc Kạn,2018,212,10,7507,3935,6714,478,340,366,3572,138
Bắc Kạn,2019,208,10,7587,4063,6768,474,326,342,3524,148
Bắc Kạn,2020,203,10,7628,4099,6843,472,335,352,3529,137
Bắc Kạn,2021,203,10,7811,4231,7056,454,320,338,3580,134
Bắc Ninh,2004,966,29,47238,23008,0,2000,1163,0,24230,837
Bắc Ninh,2005,1025,34,50951,24958,0,2151,1247,0,25993,904
Bắc Ninh,2006,1076,35,53028,26574,0,2370,1411,0,26454,959
Bắc Ninh,2007,1099,36,51570,26540,0,2510,1505,0,25030,1005
Bắc Ninh,2008,1073,37,47999,25562,0,2495,1833,0,22437,662
Bắc Ninh,2009,1027,37,45313,21177,0,2421,1516,0,24136,905
Bắc Ninh,2010,989,37,44716,23699,0,2429,1602,0,21017,827
Bắc Ninh,2011,971,36,42198,22046,0,2231,1433,0,20152,798
Bắc Ninh,2012,966,35,40620,21571,0,2252,1546,0,19049,706
Bắc Ninh,2013,946,35,39129,20780,0,2210,1506,0,18349,704
Bắc Ninh,2014,924,35,37697,20326,0,2230,1543,0,17371,687
Bắc Ninh,2015,930,35,38217,20423,0,2284,1622,0,17794,662
Bắc Ninh,2016,923,35,38254,20046,0,2285,1662,0,18208,623
Bắc Ninh,2017,951,35,39356,20687,0,2312,1686,0,18669,626
Bắc Ninh,2018,897,34,38340,20539,24,2096,1579,0,17801,517
Bắc Ninh,2019,988,34,41007,16807,1364,2012,1472,0,24200,540
Bắc Ninh,2020,1020,37,32292,17672,1418,2124,1576,0,14620,548
Bắc Ninh,2021,1048,35,43302,21920,88,2114,1576,0,21382,538
Bến Tre,2004,1066,40,43476,23001,0,1548,836,0,20475,712
Bến Tre,2005,1052,40,44549,24051,0,1615,870,0,20498,745
Bến Tre,2006,1033,40,42571,20583,0,1727,938,0,21988,789
Bến Tre,2007,984,41,40867,22635,0,1840,1088,0,18232,752
Bến Tre,2008,939,30,38857,22096,0,1861,1029,0,16761,832
Bến Tre,2009,933,31,38753,22173,0,1903,1065,0,16580,838
Bến Tre,2010,914,31,37240,21452,0,1989,1108,0,15788,881
Bến Tre,2011,869,31,35203,20423,0,1890,1053,0,14780,837
Bến Tre,2012,842,31,34155,19739,0,1929,1076,0,14416,853
Bến Tre,2013,800,32,31239,17829,0,1924,1067,0,13410,857
Bến Tre,2014,795,32,30700,17567,0,1889,1062,0,13133,827
Bến Tre,2015,787,32,30559,17568,0,1876,1064,0,12991,812
Bến Tre,2016,785,33,31661,18388,0,1857,1050,0,13273,807
Bến Tre,2017,781,33,31835,18573,0,1812,1024,0,13262,788
Bến Tre,2018,798,34,23203,19443,75,1803,1024,0,3760,779
Bến Tre,2019,797,34,33402,19443,90,1807,1023,0,13959,784
Bến Tre,2020,800,35,33806,19291,75,1748,987,0,14515,761
Bến Tre,2021,765,35,32201,18387,94,1746,990,0,13814,756
Cao Bằng,2004,476,13,20067,10617,18856,599,415,491,9450,184
Cao Bằng,2005,523,17,23386,11943,22104,599,423,464,11443,176
Cao Bằng,2006,556,16,23816,11041,22735,784,537,632,12775,247
Cao Bằng,2007,518,17,21683,11821,19932,858,611,693,9862,247
Cao Bằng,2008,523,20,20402,11964,19720,969,677,792,8438,292
Cao Bằng,2009,462,21,16971,9933,16378,1004,659,790,7038,345
Cao Bằng,2010,433,21,15574,9068,15043,1008,724,826,6506,284
Cao Bằng,2011,397,22,14147,8397,13064,941,675,780,5750,266
Cao Bằng,2012,408,23,14442,7997,13916,950,584,735,6445,366
Cao Bằng,2013,397,23,13804,7590,13324,964,705,797,6214,259
Cao Bằng,2014,380,23,12926,7074,12436,936,690,772,5852,246
Cao Bằng,2015,371,23,12475,6788,11997,894,664,738,5687,230
Cao Bằng,2016,364,23,12175,6666,11706,885,662,737,5509,223
Cao Bằng,2017,372,24,12406,6676,11928,869,642,737,5730,227
Cao Bằng,2018,377,24,12634,6809,12169,826,629,708,5825,197
Cao Bằng,2019,367,24,12771,6801,12279,816,616,680,5970,200
Cao Bằng,2020,372,24,13037,6852,12426,830,624,696,6185,206
Cao Bằng,2021,378,24,13508,7141,12891,806,615,686,6367,191
Cà Mau,2004,588,13,26428,13341,694,900,405,0,13087,495
Cà Mau,2005,619,15,28679,12990,424,903,372,0,15689,531
Cà Mau,2006,630,18,29632,13600,838,1347,581,0,16032,766
Cà Mau,2007,635,20,27170,13271,526,1258,456,0,13899,802
Cà Mau,2008,620,20,25540,12259,470,1359,489,0,13281,870
Cà Mau,2009,605,20,24501,11760,470,1395,502,0,12741,893
Cà Mau,2010,627,21,24459,12112,467,1420,937,0,12347,483
Cà Mau,2011,622,21,24491,12087,507,1530,703,0,12404,827
Cà Mau,2012,630,23,23905,12666,443,1574,605,0,11239,969
Cà Mau,2013,605,23,22205,10873,95,1594,756,0,11332,838
Cà Mau,2014,657,24,23447,11606,452,1690,819,0,11841,871
Cà Mau,2015,703,25,24779,12322,499,1676,819,0,12457,857
Cà Mau,2016,753,26,27438,13637,510,1676,827,0,13801,849
Cà Mau,2017,785,26,29896,14823,615,1694,848,33,15073,846
Cà Mau,2018,779,26,30500,15913,817,1692,878,38,14587,814
Cà Mau,2019,813,25,33398,16721,896,1796,908,43,16677,888
Cà Mau,2020,817,24,33441,16827,807,1821,929,47,16614,892
Cà Mau,2021,805,23,32243,16102,846,1817,928,48,16141,889
Cần Thơ,2004,589,13,23725,12225,382,761,457,0,11500,304
Cần Thơ,2005,622,15,27322,14010,545,1096,617,0,13312,479
Cần Thơ,2006,671,15,28416,13784,850,1369,727,0,14632,642
Cần Thơ,2007,653,16,27765,14521,636,1254,726,0,13244,528
Cần Thơ,2008,665,16,27858,14709,682,1366,783,0,13149,583
Cần Thơ,2009,676,16,27159,14610,692,1419,842,0,12549,577
Cần Thơ,2010,665,18,26085,14241,722,1530,909,0,11844,621
Cần Thơ,2011,673,20,25789,14294,621,1488,890,0,11495,598
Cần Thơ,2012,698,21,26619,14555,706,1575,924,0,12064,651
Cần Thơ,2013,693,23,25212,13644,627,1727,991,0,11568,736
Cần Thơ,2014,694,22,25068,13293,781,1725,1016,0,11775,709
Cần Thơ,2015,733,23,26351,14038,810,1872,1110,0,12313,762
Cần Thơ,2016,786,23,28667,15289,868,1835,1101,0,13378,734
Cần Thơ,2017,816,23,29172,15645,975,1813,1088,30,13527,725
Cần Thơ,2018,828,24,18583,16005,987,1794,1087,32,2578,707
Cần Thơ,2019,859,24,31103,16456,1062,1783,1086,35,14647,697
Cần Thơ,2020,887,24,32571,17198,1102,1847,1137,39,15373,710
Cần Thơ,2021,904,24,33164,17360,1149,1896,1175,46,15804,721
Gia Lai,2004,731,26,31265,15834,4984,1147,603,50,15431,544
Gia Lai,2005,845,26,35241,17815,5866,1460,784,60,17426,676
Gia Lai,2006,920,28,35665,15707,5913,1727,954,70,19958,773
Gia Lai,2007,937,31,37399,20003,5605,1834,1041,69,17396,793
Gia Lai,2008,935,34,38131,20896,5946,1956,1114,74,17235,842
Gia Lai,2009,1008,37,38670,21400,5903,2147,1261,94,17270,886
Gia Lai,2010,976,38,41862,23292,3694,2131,1270,125,18570,861
Gia Lai,2011,1022,39,41960,23051,7351,2135,1258,122,18909,877
Gia Lai,2012,1029,40,41592,22727,7467,2132,1286,120,18865,846
Gia Lai,2013,1017,42,40363,21928,8323,2246,1369,138,18435,877
Gia Lai,2014,982,44,38983,21329,8594,2250,1372,141,17654,878
Gia Lai,2015,964,44,38861,21450,8709,2231,1361,125,17411,870
Gia Lai,2016,962,45,38915,22015,8392,2205,1349,143,16900,856
Gia Lai,2017,969,45,39500,22253,8432,2175,1338,142,17247,837
Gia Lai,2018,959,44,40698,22665,8677,2133,1328,144,18033,805
Gia Lai,2019,995,43,42240,23198,9334,2129,1317,147,19042,812
Gia Lai,2020,1027,43,44173,24284,9685,2108,1325,139,19889,783
Gia Lai,2021,1039,43,45889,25029,10536,2081,1306,140,20860,775
Hà Giang,2004,371,16,14925,7669,10398,624,402,180,7256,222
Hà Giang,2005,387,18,16029,7877,11020,723,461,210,8152,262
Hà Giang,2006,399,18,16308,8118,10904,791,514,247,8190,277
Hà Giang,2007,420,18,16290,8115,11382,861,545,219,8175,316
Hà Giang,2008,422,18,16136,8312,11842,969,618,292,7824,351
Hà Giang,2009,437,19,16281,8251,12109,1038,613,281,8030,425
Hà Giang,2010,454,21,16017,8119,11852,1092,635,322,7898,457
Hà Giang,2011,483,22,16377,8054,12642,1062,681,346,8323,381
Hà Giang,2012,491,22,16233,7746,12787,1097,701,369,8487,396
Hà Giang,2013,496,22,16644,7824,10612,1100,703,384,8820,397
Hà Giang,2014,499,22,16489,7637,13312,1088,704,384,8852,384
Hà Giang,2015,506,23,16404,7432,13102,1135,735,409,8972,400
Hà Giang,2016,517,23,15950,7235,12537,1142,742,423,8715,400
Hà Giang,2017,509,22,16025,7522,12453,1116,737,397,8503,379
Hà Giang,2018,498,22,15700,7481,12101,1080,718,394,8219,362
Hà Giang,2019,491,22,16255,7739,12471,1073,698,390,8516,375
Hà Giang,2020,499,22,17104,8043,13266,1054,683,384,9061,371
Hà Giang,2021,513,22,18386,8570,14642,1090,692,401,9816,398
Hà Nam,2004,554,24,26887,13594,0,1130,684,0,13293,446
Hà Nam,2005,629,24,29254,15491,0,1146,727,0,13763,419
Hà Nam,2006,671,24,30991,14812,0,1186,780,0,16179,406
Hà Nam,2007,686,25,31297,17464,0,1270,779,0,13833,491
Hà Nam,2008,638,25,29079,16375,0,1339,875,0,12704,464
Hà Nam,2009,612,25,27492,15431,0,1351,931,0,12061,420
Hà Nam,2010,606,25,27010,15339,0,1358,966,0,11671,392
Hà Nam,2011,607,27,26933,15056,0,1384,975,0,11877,409
Hà Nam,2012,600,27,26219,14775,0,1405,1043,0,11444,362
Hà Nam,2013,583,26,25196,13992,0,1340,1011,0,11204,329
Hà Nam,2014,559,23,24010,13151,0,1285,981,0,10859,304
Hà Nam,2015,549,23,23531,12896,0,1291,990,0,10635,301
Hà Nam,2016,544,23,23356,12978,0,1076,744,0,10378,332
Hà Nam,2017,544,23,23477,12951,0,1267,981,0,10526,286
Hà Nam,2018,552,22,23794,13157,12,1176,992,0,10637,184
Hà Nam,2019,559,22,23816,13088,17,1284,1003,0,10728,281
Hà Nam,2020,571,22,24075,13378,18,1282,1010,0,10697,272
Hà Nam,2021,572,22,23410,12877,22,1264,1001,0,10533,263
Hà Nội,2004,2299,96,103233,51366,0,4970,3107,0,51867,1863
Hà Nội,2005,2433,81,108096,54504,0,5263,3591,0,53592,1672
Hà Nội,2006,2612,100,116514,58529,269,5710,3783,38,57985,1927
Hà Nội,2007,2677,103,119929,60359,230,6019,4276,38,59570,1743
Hà Nội,2008,5008,182,224293,119201,1847,11473,8063,63,105092,3410
Hà Nội,2009,4939,186,216376,114796,1853,12076,8138,63,101580,3938
Hà Nội,2010,4985,162,212842,113594,1821,12407,8872,65,99248,3535
Hà Nội,2011,4973,167,212961,112525,1,12153,8645,70,100436,3508
Hà Nội,2012,4886,168,206472,108795,1752,12363,8510,75,97677,3853
Hà Nội,2013,4782,205,195254,101537,5781,12436,9025,86,93717,3411
Hà Nội,2014,4824,183,188402,97106,1839,12072,8815,81,91296,3257
Hà Nội,2015,4782,183,180879,96545,1889,11178,8248,96,84334,2930
Hà Nội,2016,4940,180,190934,100548,2249,11807,8521,86,90386,3286
Hà Nội,2017,5102,187,196553,101967,2361,11705,8650,76,94586,3055
Hà Nội,2018,5418,192,217130,114742,3136,9723,8567,96,102388,1156
Hà Nội,2019,5872,196,235445,123183,5160,11174,8484,116,112262,2690
Hà Nội,2020,6293,195,257671,133547,5450,11751,8986,130,124124,2765
Hà Nội,2021,6411,199,262168,135178,4806,12125,9250,143,126990,2875
Hà Tĩnh,2004,1345,41,67677,33518,0,2458,1320,0,34159,1138
Hà Tĩnh,2005,1391,42,63000,31185,0,2709,1343,0,31815,1366
Hà Tĩnh,2006,1357,43,70297,34149,0,2815,1675,0,36148,1140
Hà Tĩnh,2007,1462,44,71578,34575,0,3074,1722,0,37003,1352
Hà Tĩnh,2008,1451,45,70969,35994,0,3238,1874,0,34975,1364
Hà Tĩnh,2009,1411,45,64532,33621,0,3217,1964,0,30911,1253
Hà Tĩnh,2010,1389,46,64675,33533,0,3294,2052,0,31142,1242
Hà Tĩnh,2011,1348,45,61036,31829,0,3111,1911,0,29207,1200
Hà Tĩnh,2012,1291,45,56607,29287,0,3129,1917,0,27320,1212
Hà Tĩnh,2013,1236,44,52013,27132,0,3047,1952,0,24881,1095
Hà Tĩnh,2014,1180,43,47686,24967,0,2973,1878,0,22719,1095
Hà Tĩnh,2015,1176,43,45638,23982,0,2972,1856,0,21656,1116
Hà Tĩnh,2016,1184,42,44940,23932,0,2941,1840,0,21008,1101
Hà Tĩnh,2017,1187,42,43805,22890,0,2882,1887,0,20915,995
Hà Tĩnh,2018,1191,42,44394,23070,115,2763,1862,0,21324,901
Hà Tĩnh,2019,1198,42,43815,22717,112,2768,1838,0,21098,930
Hà Tĩnh,2020,1200,41,43854,23242,116,2774,1854,0,20612,920
Hà Tĩnh,2021,1192,41,42491,22867,107,2735,1826,0,19624,909
Hòa Bình,2004,608,33,28119,13960,18072,1108,700,255,14159,408
Hòa Bình,2005,659,32,29736,15007,19648,1130,681,275,14729,449
Hòa Bình,2006,698,32,31737,15307,21186,1261,778,320,16430,483
Hòa Bình,2007,729,34,29936,14010,19677,1379,871,326,15926,508
Hòa Bình,2008,650,35,27213,15000,18338,1470,925,369,12213,545
Hòa Bình,2009,657,38,26696,14619,18113,1588,1018,435,12077,570
Hòa Bình,2010,649,38,26034,14276,18406,1700,1138,542,11758,562
Hòa Bình,2011,675,38,25673,13867,16936,1642,1063,534,11806,579
Hòa Bình,2012,678,37,25055,12611,16648,1635,1073,525,12444,562
Hòa Bình,2013,743,37,24993,12310,15776,1561,1041,492,12683,520
Hòa Bình,2014,677,37,23836,12165,16532,1553,1046,460,11671,507
Hòa Bình,2015,684,37,24095,12714,16709,1532,1044,474,11381,488
Hòa Bình,2016,689,37,24302,12845,16775,1526,1048,444,11457,478
Hòa Bình,2017,696,37,24896,12738,16758,1502,1041,462,12158,461
Hòa Bình,2018,708,36,24348,12643,16800,1526,1069,476,11705,457
Hòa Bình,2019,719,36,25555,21107,6120,1565,1097,490,4448,468
Hòa Bình,2020,729,36,26504,14022,18828,1598,1127,534,12482,471
Hòa Bình,2021,732,36,26498,14196,18889,1553,1102,541,12302,451
Hưng Yên,2004,836,49,43479,20994,0,1468,899,0,22485,569
Hưng Yên,2005,932,29,48642,23473,0,1656,1058,0,25169,598
Hưng Yên,2006,1018,30,51287,26059,0,1811,1145,0,25228,666
Hưng Yên,2007,1025,33,48171,25218,0,2002,1256,0,22953,746
Hưng Yên,2008,968,26,43560,23044,0,2038,1385,0,20516,653
Hưng Yên,2009,924,37,41148,21619,0,2091,1463,0,19529,628
Hưng Yên,2010,877,37,38619,20782,0,2113,1467,0,17837,646
Hưng Yên,2011,864,37,37230,20014,0,2104,1491,0,17216,613
Hưng Yên,2012,881,37,37123,19363,0,2385,1739,0,17760,646
Hưng Yên,2013,841,38,34637,18472,0,1976,1487,0,16165,489
Hưng Yên,2014,837,38,33079,16704,0,1978,1493,0,16375,485
Hưng Yên,2015,836,38,32679,17217,0,1978,1433,0,15462,545
Hưng Yên,2016,837,38,32594,17251,0,1955,1482,0,15343,473
Hưng Yên,2017,848,37,32983,17780,0,1914,1464,0,15203,450
Hưng Yên,2018,860,36,33396,17531,13,1818,1422,0,15865,396
Hưng Yên,2019,872,35,33467,17533,11,1805,1380,0,15934,425
Hưng Yên,2020,902,35,35081,18320,37,1816,1392,0,16761,424
Hưng Yên,2021,914,35,36819,18848,46,1828,1401,0,17971,427
Hải Dương,2004,1280,43,64517,30648,0,2067,1222,0,33869,845
Hải Dương,2005,1313,43,68563,33348,0,2166,1349,0,35215,817
Hải Dương,2006,1361,46,70713,33550,275,2308,1434,0,37163,874
Hải Dương,2007,1373,50,69105,33991,134,2450,1552,0,35114,898
Hải Dương,2008,1352,52,65764,32343,125,2495,1581,0,33421,914
Hải Dương,2009,1375,53,62861,31849,145,2418,1505,0,31012,913
Hải Dương,2010,1296,53,59795,29718,138,2955,1839,0,30077,1116
Hải Dương,2011,1256,54,55804,28987,164,2746,1848,0,26817,898
Hải Dương,2012,1255,54,53833,28673,287,2707,1818,0,25160,889
Hải Dương,2013,1194,54,51521,27044,173,2670,1871,0,24477,799
Hải Dương,2014,1219,54,50886,26872,168,2811,1960,0,24014,851
Hải Dương,2015,1216,54,50236,26717,171,2784,1962,0,23519,822
Hải Dương,2016,1240,54,49363,26597,140,2817,2042,0,22766,775
Hải Dương,2017,1246,54,49825,26815,143,2797,2044,0,23010,753
Hải Dương,2018,1259,54,50360,26939,138,2620,1952,0,23421,668
Hải Dương,2019,1237,54,50888,27047,158,2519,1861,0,23841,658
Hải Dương,2020,1292,55,54329,27995,178,2571,1935,0,26334,636
Hải Dương,2021,1331,55,55779,28505,191,2554,1918,0,27274,636
Hải Phòng,2004,1394,52,67818,33695,0,3270,2171,0,34123,1099
Hải Phòng,2005,1520,53,73957,36305,0,3475,2297,0,37652,1178
Hải Phòng,2006,1585,54,77992,38910,0,3619,2427,0,39082,1192
Hải Phòng,2007,1600,58,77522,39309,0,3738,2527,0,38213,1211
Hải Phòng,2008,1591,55,75747,38779,0,3708,2514,0,36968,1194
Hải Phòng,2009,1589,57,71950,35401,0,3888,2582,0,36549,1306
Hải Phòng,2010,1571,53,70533,35950,0,4107,2865,0,34583,1242
Hải Phòng,2011,1490,51,63175,31849,0,4121,2862,0,31326,1259
Hải Phòng,2012,1399,50,60346,30277,0,3822,2756,0,30069,1066
Hải Phòng,2013,1324,51,56876,27904,0,3764,2715,0,28972,1049
Hải Phòng,2014,1274,52,52739,26893,0,3662,2651,0,25846,1011
Hải Phòng,2015,1230,55,52613,27652,0,3502,2521,0,24961,981
Hải Phòng,2016,1294,55,52882,27377,0,3427,2456,0,25505,971
Hải Phòng,2017,1344,57,53412,27316,0,3373,2424,0,26096,949
Hải Phòng,2018,1386,58,57549,30186,18,2945,2246,0,27363,699
Hải Phòng,2019,1402,58,61824,32643,24,2849,2068,0,29181,781
Hải Phòng,2020,1432,57,61741,32283,67,2877,2076,0,29458,801
Hải Phòng,2021,1490,57,63730,33424,87,2896,2101,0,30306,795
Hậu Giang,2004,390,6,16263,7542,369,637,291,0,8721,346
Hậu Giang,2005,432,7,17971,8857,245,681,340,0,9114,341
Hậu Giang,2006,469,13,18675,9303,158,797,375,0,9372,422
Hậu Giang,2007,481,13,19011,9584,352,866,402,0,9427,464
Hậu Giang,2008,463,21,17796,8473,127,932,423,0,9323,509
Hậu Giang,2009,464,16,16082,8341,336,938,435,0,7741,503
Hậu Giang,2010,431,18,15470,7986,386,972,443,0,7484,529
Hậu Giang,2011,440,19,16283,7399,431,1023,427,0,8884,596
Hậu Giang,2012,451,19,16615,8752,432,1058,470,0,7863,588
Hậu Giang,2013,435,19,15974,8126,424,1152,559,0,7848,593
Hậu Giang,2014,438,19,15941,8090,407,1068,506,0,7851,562
Hậu Giang,2015,442,19,16640,8549,441,1051,496,0,8091,555
Hậu Giang,2016,458,19,17761,9340,488,1057,501,0,8421,556
Hậu Giang,2017,469,19,18119,9477,435,1043,504,0,8642,539
Hậu Giang,2018,477,19,26602,9792,481,1039,502,0,16810,537
Hậu Giang,2019,478,19,19202,9915,556,1035,499,0,9287,536
Hậu Giang,2020,494,19,20210,10317,623,1043,512,0,9893,531
Hậu Giang,2021,497,20,20374,10635,649,1055,512,0,9739,543
Khánh Hòa,2004,726,15,32777,17133,933,1239,621,12,15644,618
Khánh Hòa,2005,788,19,36466,20209,656,1334,747,13,16257,587
Khánh Hòa,2006,822,22,37256,18384,535,1464,830,16,18872,634
Khánh Hòa,2007,856,23,38568,21431,848,1555,895,27,17137,660
Khánh Hòa,2008,877,25,39235,22393,768,1725,1005,27,16842,720
Khánh Hòa,2009,899,31,39383,22836,832,1821,1100,25,16547,721
Khánh Hòa,2010,916,29,39134,22320,834,1942,1174,32,16814,768
Khánh Hòa,2011,928,26,38173,21670,842,2046,1281,38,16503,765
Khánh Hòa,2012,898,27,36434,20927,717,1952,1215,43,15507,737
Khánh Hòa,2013,932,27,35615,20188,1011,2085,1307,42,15427,778
Khánh Hòa,2014,939,27,35171,19768,1193,2090,1327,21,15403,763
Khánh Hòa,2015,963,28,35264,19891,1246,2137,1369,17,15373,768
Khánh Hòa,2016,965,29,36202,20662,1148,2157,1389,34,15540,768
Khánh Hòa,2017,946,27,36225,20734,1121,2128,1391,44,15491,737
Khánh Hòa,2018,941,27,36241,20770,1091,2071,1346,50,15471,725
Khánh Hòa,2019,911,27,36774,20860,1111,1988,1301,57,15914,687
Khánh Hòa,2020,911,27,37304,20583,1138,2011,1321,56,16721,690
Khánh Hòa,2021,907,29,37213,20646,1076,2038,1299,55,16567,739
Kiên Giang,2004,867,24,36487,17533,2781,1420,658,42,18954,762
Kiên Giang,2005,933,27,39799,18617,2948,1636,734,56,21182,902
Kiên Giang,2006,950,28,41022,20134,3487,1755,807,63,20888,948
Kiên Giang,2007,987,29,41818,20445,3894,1980,940,70,21373,1040
Kiên Giang,2008,992,28,41293,20749,3779,2115,1018,72,20544,1097
Kiên Giang,2009,976,26,38935,18285,3537,2191,1085,89,20650,1106
Kiên Giang,2010,896,27,34450,18075,2977,2192,1107,88,16375,1085
Kiên Giang,2011,902,28,34843,18097,2910,2086,1037,93,16746,1049
Kiên Giang,2012,924,25,35506,18599,3151,2138,1067,98,16907,1071
Kiên Giang,2013,910,23,34055,17727,2938,2143,1071,94,16328,1072
Kiên Giang,2014,907,23,33268,17233,3419,2115,1052,101,16035,1063
Kiên Giang,2015,933,23,34632,18090,3475,2089,1056,108,16542,1033
Kiên Giang,2016,954,24,36061,19021,3494,2105,1085,113,17040,1020
Kiên Giang,2017,951,24,36577,19606,3441,2079,1061,108,16971,1018
Kiên Giang,2018,931,24,29907,19648,3474,2047,1049,122,10259,998
Kiên Giang,2019,948,23,37988,20391,3802,2030,1037,136,17597,993
Kiên Giang,2020,979,23,39990,21355,3999,2073,1076,143,18635,997
Kiên Giang,2021,991,23,40615,21598,4303,2080,1075,150,19017,1005
Kon Tum,2004,290,4,11420,5842,0,567,316,33,5578,251
Kon Tum,2005,279,6,12628,6607,0,726,410,38,6021,316
Kon Tum,2006,329,6,13039,6197,3457,725,441,47,6842,284
Kon Tum,2007,289,6,12632,6873,3279,838,535,63,5759,303
Kon Tum,2008,317,11,12798,7030,3599,709,441,66,5768,268
Kon Tum,2009,336,10,12356,6915,3210,876,562,54,5441,314
Kon Tum,2010,360,14,13012,7515,3694,983,629,59,5497,354
Kon Tum,2011,379,14,13877,7991,4098,1016,677,76,5886,339
Kon Tum,2012,399,13,14013,7580,4612,1019,637,93,6433,382
Kon Tum,2013,385,13,13031,7474,4745,1053,689,77,5557,364
Kon Tum,2014,378,16,13110,7544,5086,1102,730,107,5566,372
Kon Tum,2015,395,16,13186,7726,5236,1061,708,102,5460,353
Kon Tum,2016,388,16,13298,7787,4925,1050,705,111,5511,345
Kon Tum,2017,409,17,13900,8031,5241,1046,697,113,5869,349
Kon Tum,2018,406,17,13673,7895,4922,1046,692,114,5778,354
Kon Tum,2019,411,17,14177,8138,5149,1028,688,115,6039,340
Kon Tum,2020,419,18,15090,8513,5462,1043,702,120,6577,341
Kon Tum,2021,408,17,14694,8374,5195,995,674,111,6320,321
Lai Châu,2004,94,7,3581,1526,1790,161,94,26,2055,67
Lai Châu,2005,113,8,4297,1879,2315,214,114,25,2418,100
Lai Châu,2006,135,9,5060,2277,2920,271,143,16,2783,128
Lai Châu,2007,156,11,5591,2593,3513,350,189,41,2998,161
Lai Châu,2008,171,13,5820,2664,3746,395,205,36,3156,190
Lai Châu,2009,179,16,5700,2647,2721,445,231,47,3053,214
Lai Châu,2010,187,16,5870,2673,3916,447,248,51,3197,199
Lai Châu,2011,206,18,6350,2769,4514,497,284,60,3581,213
Lai Châu,2012,220,18,6807,2954,5114,526,309,68,3853,217
Lai Châu,2013,66,22,7584,3210,6006,544,324,73,4374,220
Lai Châu,2014,250,19,8260,3516,6673,558,343,72,4744,215
Lai Châu,2015,274,21,8769,3760,7111,661,409,89,5009,252
Lai Châu,2016,284,22,8966,3896,7257,700,440,94,5070,260
Lai Châu,2017,291,22,9241,4078,7469,682,433,96,5163,249
Lai Châu,2018,295,24,9681,4348,7720,684,419,94,5333,265
Lai Châu,2019,296,25,10175,4288,8998,647,405,91,5887,242
Lai Châu,2020,294,23,10997,5145,8680,633,399,87,5852,234
Lai Châu,2021,292,23,11721,5460,9181,610,386,83,6261,224
Long An,2004,842,28,37715,19824,0,1225,593,0,17891,632
Long An,2005,917,28,41396,20840,0,1373,779,0,20556,594
Long An,2006,939,29,42225,20513,0,1475,861,0,21712,614
Long An,2007,957,29,42819,23228,0,1527,891,0,19591,636
Long An,2008,953,30,41489,21159,0,1740,1015,0,20330,725
Long An,2009,968,31,41860,23133,0,2057,1211,0,18727,846
Long An,2010,975,31,42544,23933,0,2054,1177,0,18611,877
Long An,2011,1006,33,40645,22803,0,2225,1300,0,17842,925
Long An,2012,1007,33,40369,23106,0,2445,1450,0,17263,995
Long An,2013,984,33,37969,21495,0,2471,1510,0,16474,961
Long An,2014,1008,33,37040,20844,0,2525,1556,0,16196,969
Long An,2015,976,34,36798,20804,0,2465,1518,0,15994,947
Long An,2016,1000,34,38309,21874,0,2437,1498,0,16435,939
Long An,2017,1003,33,39637,22589,0,2386,1465,0,17048,921
Long An,2018,1053,32,44130,23505,80,2298,1470,0,20625,828
Long An,2019,1067,30,42146,24124,110,2372,1476,0,18022,896
Long An,2020,1082,30,43380,24809,111,2370,1477,0,18571,893
Long An,2021,1076,31,43014,24620,111,2376,1476,0,18394,900
Lào Cai,2004,342,21,13919,6771,5173,620,411,80,7148,209
Lào Cai,2005,404,24,16650,8087,7188,722,472,86,8563,250
Lào Cai,2006,447,25,18742,9022,8402,826,532,103,9720,294
Lào Cai,2007,454,26,17731,8781,8025,913,591,133,8950,322
Lào Cai,2008,422,26,16076,8306,6903,949,564,127,7770,385
Lào Cai,2009,427,26,15826,7761,6998,1011,638,163,8065,373
Lào Cai,2010,435,27,16088,8078,6796,1055,606,145,8010,449
Lào Cai,2011,459,27,16783,8386,8355,1091,724,176,8397,367
Lào Cai,2012,468,27,16652,8203,8796,1126,694,207,8449,432
Lào Cai,2013,482,27,16763,8164,9524,1112,730,212,8599,382
Lào Cai,2014,494,27,16810,8078,9899,1143,758,211,8732,385
Lào Cai,2015,505,27,17017,8268,10160,1180,794,241,8749,386
Lào Cai,2016,526,27,17574,8630,10582,1133,757,215,8944,376
Lào Cai,2017,543,27,18392,9015,10910,1176,787,231,9377,389
Lào Cai,2018,536,27,18605,9054,10618,1060,791,236,9551,269
Lào Cai,2019,518,27,19735,9557,11633,1151,795,241,10178,356
Lào Cai,2020,534,27,20634,10200,12307,1176,808,250,10434,368
Lào Cai,2021,554,27,21529,10783,13130,1147,782,246,10746,365
Lâm Đồng,2004,985,17,41449,21314,4433,1825,998,24,20135,827
Lâm Đồng,2005,1086,51,44538,23685,5822,2018,1133,25,20853,885
Lâm Đồng,2006,1149,25,45893,21548,7022,2347,1315,24,24345,1032
Lâm Đồng,2007,1170,28,46789,25614,6591,2372,1228,69,21175,1144
Lâm Đồng,2008,1220,33,47470,24350,6830,2461,1318,72,23120,1143
Lâm Đồng,2009,1229,38,47068,26360,6910,2604,1566,107,20708,1038
Lâm Đồng,2010,1227,36,47413,26977,6848,2578,1590,125,20436,988
Lâm Đồng,2011,1260,37,47519,26572,7782,2636,1821,132,20947,815
Lâm Đồng,2012,1270,46,46862,26267,5004,2465,1216,140,20595,1249
Lâm Đồng,2013,1243,47,44810,24965,7945,2696,1710,164,19845,986
Lâm Đồng,2014,1243,47,43613,24323,7746,2815,1803,185,19290,1012
Lâm Đồng,2015,1247,48,43566,24407,7903,2787,1788,171,19159,999
Lâm Đồng,2016,1258,49,44339,24560,7623,2784,1798,183,19779,986
Lâm Đồng,2017,1246,48,43370,23734,7751,2762,1760,202,19636,1002
Lâm Đồng,2018,1199,48,42161,23418,7261,2639,1749,204,18743,890
Lâm Đồng,2019,1198,47,42717,23617,7685,2657,1738,207,19100,919
Lâm Đồng,2020,1198,46,43651,24073,7993,2669,1730,208,19578,939
Lâm Đồng,2021,1213,46,44450,24563,8388,2604,1697,206,19887,907
Lạng Sơn,2004,582,19,26960,14513,21788,828,523,452,12447,305
Lạng Sơn,2005,645,19,29615,16436,24113,887,585,471,13179,302
Lạng Sơn,2006,646,22,30112,15194,24076,1040,666,539,14918,374
Lạng Sơn,2007,634,22,28245,16647,22851,1197,791,612,11598,406
Lạng Sơn,2008,607,21,26573,15721,21094,1376,898,645,10852,478
Lạng Sơn,2009,645,23,25966,15479,21745,1423,934,753,10487,489
Lạng Sơn,2010,680,25,26091,15479,21795,1514,1005,857,10612,509
Lạng Sơn,2011,677,25,26131,15133,22233,1628,1045,936,10998,583
Lạng Sơn,2012,688,24,26352,14778,22758,1682,1117,1014,11574,565
Lạng Sơn,2013,688,24,25202,13918,21725,1699,1159,1071,11284,540
Lạng Sơn,2014,694,24,24256,13297,20869,1683,1149,1039,10959,534
Lạng Sơn,2015,696,25,23633,13178,20184,1589,1076,950,10455,513
Lạng Sơn,2016,683,25,23026,12788,19663,1565,1067,933,10238,498
Lạng Sơn,2017,660,26,22999,12729,19552,1538,1067,873,10270,471
Lạng Sơn,2018,647,26,22858,12827,18918,1455,1022,842,10031,433
Lạng Sơn,2019,639,27,22898,16650,28605,1416,976,810,6248,440
Lạng Sơn,2020,646,26,23210,12985,19686,1459,1023,877,10225,436
Lạng Sơn,2021,666,26,23195,12857,19690,1466,1062,863,10338,404
Nam Định,2004,1114,43,60292,28632,0,2464,1403,0,31660,1061
Nam Định,2005,1270,43,64498,32667,0,2516,1428,0,31831,1088
Nam Định,2006,1341,46,67637,33480,0,2605,1561,0,34157,1044
Nam Định,2007,1404,53,68928,35310,0,2903,1731,0,33618,1172
Nam Định,2008,1421,53,68332,36140,0,3133,1908,0,32192,1225
Nam Định,2009,1437,54,69970,35598,0,3197,2011,0,34372,1186
Nam Định,2010,1445,55,67507,35707,0,3229,2107,0,31800,1122
Nam Định,2011,1494,56,69071,36610,0,3254,2166,0,32461,1088
Nam Định,2012,1401,56,62434,32771,0,3203,2197,0,29663,1006
Nam Định,2013,1375,55,59861,31345,0,3200,2222,0,28516,978
Nam Định,2014,1352,57,56426,29361,0,3215,2255,0,27065,960
Nam Định,2015,1352,57,54201,28689,0,3214,2294,0,25512,920
Nam Định,2016,1348,57,52070,27665,0,3147,2261,0,24405,886
Nam Định,2017,1352,57,51418,27552,0,3127,2250,0,23866,877
Nam Định,2018,1354,57,52119,28063,35,2897,2186,0,24056,711
Nam Định,2019,1355,57,52971,28515,41,2896,2122,0,24456,774
Nam Định,2020,1359,57,53050,28403,54,2832,2060,0,24647,772
Nam Định,2021,1367,57,54264,29248,69,2850,2093,0,25016,757
Nghệ An,2004,2791,84,132250,58175,10235,5191,2508,96,74075,2683
Nghệ An,2005,3003,84,142083,68980,11357,5514,2723,160,73103,2791
Nghệ An,2006,3083,89,143955,70071,12592,5694,2611,206,73884,3083
Nghệ An,2007,3070,89,135343,67508,13970,5992,2816,224,67835,3176
Nghệ An,2008,2910,90,132249,68630,9323,6019,3343,135,63619,2676
Nghệ An,2009,2831,90,124512,66013,9768,6072,3418,175,58499,2654
Nghệ An,2010,2793,90,123241,66326,10835,6075,3420,175,56915,2655
Nghệ An,2011,2755,91,117783,60499,10809,5962,3536,176,57284,2426
Nghệ An,2012,2650,91,108821,56414,9363,5893,3535,176,52407,2358
Nghệ An,2013,2560,90,99261,52397,9411,5814,3512,174,46864,2302
Nghệ An,2014,2486,89,91977,48516,9474,5660,3456,181,43461,2204
Nghệ An,2015,2434,88,88985,46831,9485,5564,3391,181,42154,2173
Nghệ An,2016,2442,89,90190,48147,9856,5503,3365,172,42043,2138
Nghệ An,2017,2424,90,90001,47476,10064,5444,3378,174,42525,2066
Nghệ An,2018,2413,89,91608,48045,10105,5052,3314,166,43563,1738
Nghệ An,2019,2407,88,94641,49163,10619,5172,3251,157,45478,1921
Nghệ An,2020,2450,89,99755,51788,11244,5275,3360,162,47967,1915
Nghệ An,2021,2491,89,103231,53288,12306,5330,3431,160,49943,1899
Ninh Bình,2004,675,25,35352,18137,724,1246,712,0,17215,534
Ninh Bình,2005,716,25,37247,19189,681,1402,877,0,18058,525
Ninh Bình,2006,763,26,40002,20070,694,1440,957,26,19932,483
Ninh Bình,2007,770,27,38999,20540,431,1505,929,18,18459,576
Ninh Bình,2008,739,27,35306,18725,842,1506,1055,46,16581,451
Ninh Bình,2009,712,27,32443,18045,545,1586,1052,46,14398,534
Ninh Bình,2010,699,27,30914,17401,560,1545,1062,37,13513,483
Ninh Bình,2011,671,27,28774,15624,562,1492,1022,44,13150,470
Ninh Bình,2012,657,27,26835,14763,564,1544,974,51,12072,570
Ninh Bình,2013,647,27,24973,13913,528,1535,1126,74,11060,409
Ninh Bình,2014,647,27,23894,13085,542,1532,1129,61,10809,403
Ninh Bình,2015,657,27,23960,13572,575,1547,1154,63,10388,393
Ninh Bình,2016,663,27,24340,13773,630,1580,1181,59,10567,399
Ninh Bình,2017,668,27,24763,13840,669,1593,1200,53,10923,393
Ninh Bình,2018,678,26,25432,13747,689,1589,1209,62,11685,380
Ninh Bình,2019,690,26,26309,14083,741,1599,1218,72,12226,381
Ninh Bình,2020,700,26,27892,15104,826,1610,1234,74,12788,376
Ninh Bình,2021,708,27,28652,15643,971,1615,1244,80,13009,371
Ninh Thuận,2004,315,4,14032,7698,2142,566,277,82,6334,289
Ninh Thuận,2005,349,6,16342,8989,2577,636,308,100,7353,328
Ninh Thuận,2006,400,9,17850,8036,3171,708,338,120,9814,370
Ninh Thuận,2007,411,9,18615,10608,3194,777,388,140,8007,389
Ninh Thuận,2008,384,13,18799,11673,2977,879,432,160,7126,447
Ninh Thuận,2009,448,15,17574,10799,3444,907,471,165,6775,436
Ninh Thuận,2010,465,18,18954,11838,4039,965,469,147,7116,496
Ninh Thuận,2011,468,18,19119,11427,3950,1004,484,174,7692,520
Ninh Thuận,2012,490,19,19788,11315,3764,1127,588,201,8473,539
Ninh Thuận,2013,456,19,17479,10134,3919,1016,546,205,7345,470
Ninh Thuận,2014,449,18,16497,9517,3751,1023,558,207,6980,465
Ninh Thuận,2015,439,18,16340,9552,3824,994,542,201,6788,452
Ninh Thuận,2016,440,17,16172,9525,3753,1013,559,203,6647,454
Ninh Thuận,2017,442,17,16378,9715,3766,945,536,162,6663,409
Ninh Thuận,2018,437,16,16427,9670,3635,690,538,180,6757,152
Ninh Thuận,2019,451,15,16574,9674,3585,955,539,198,6900,416
Ninh Thuận,2020,450,15,17363,10058,3637,983,567,203,7305,416
Ninh Thuận,2021,458,15,17648,10123,3756,983,567,208,7525,416
Phú Thọ,2004,1105,48,55296,25948,6086,2241,1371,77,29348,870
Phú Thọ,2005,1138,50,57036,27250,6212,2320,1363,96,29786,957
Phú Thọ,2006,1134,51,55150,28088,6006,2432,1487,100,27062,945
Phú Thọ,2007,1077,53,49476,26079,5136,2575,1582,106,23397,993
Phú Thọ,2008,1020,54,45994,23347,5196,2457,1574,108,22647,883
Phú Thọ,2009,973,55,44135,21229,5591,2635,1691,174,22906,944
Phú Thọ,2010,1003,47,44070,23826,5893,2559,1686,113,20244,873
Phú Thọ,2011,982,44,41552,22016,5825,2340,1556,117,19536,784
Phú Thọ,2012,967,44,39621,19133,5479,2150,1450,121,20488,700
Phú Thọ,2013,934,44,36873,19090,5745,2176,1481,159,17783,695
Phú Thọ,2014,922,44,35469,18523,4963,2205,1526,175,16946,679
Phú Thọ,2015,927,44,35662,18705,4863,2275,1586,162,16957,689
Phú Thọ,2016,926,43,36046,19081,5258,2231,1552,160,16965,679
Phú Thọ,2017,941,43,37079,19887,5566,2258,1567,192,17192,691
Phú Thọ,2018,959,43,37802,20398,5651,1923,1516,198,17404,407
Phú Thọ,2019,976,43,39509,13338,18062,2085,1464,205,26171,621
Phú Thọ,2020,996,43,40284,21302,6241,2107,1484,211,18982,623
Phú Thọ,2021,1012,44,40529,21827,6325,2148,1511,211,18702,637
Phú Yên,2004,608,22,27435,13806,605,1619,720,0,13629,899
Phú Yên,2005,714,22,32225,16301,779,1494,792,0,15924,702
Phú Yên,2006,757,23,33794,16239,977,1624,869,11,17555,755
Phú Yên,2007,746,23,32973,17097,976,1530,816,10,15876,714
Phú Yên,2008,746,23,32886,17412,902,1570,860,10,15474,710
Phú Yên,2009,735,23,32098,16990,942,1605,845,10,15108,760
Phú Yên,2010,745,23,31244,17518,988,1774,991,15,13726,783
Phú Yên,2011,856,25,34636,19255,1263,1975,1131,22,15381,844
Phú Yên,2012,789,24,31680,17420,1032,1778,1050,30,14260,728
Phú Yên,2013,790,24,31097,16735,1162,1923,1151,28,14362,772
Phú Yên,2014,799,26,31363,17051,1231,1935,1151,26,14312,784
Phú Yên,2015,812,26,31333,17055,1302,1892,1112,27,14278,780
Phú Yên,2016,810,25,31628,17628,1285,1883,1104,29,14000,779
Phú Yên,2017,802,25,30987,17152,1295,1912,1136,29,13835,776
Phú Yên,2018,784,25,30995,17038,1198,1749,1092,27,13957,657
Phú Yên,2019,799,25,31595,17263,1285,1732,1047,25,14332,685
Phú Yên,2020,805,25,31994,17612,1286,1691,1029,25,14382,662
Phú Yên,2021,790,25,31755,17443,1352,1695,1038,25,14312,657
Quảng Bình,2004,806,26,36751,17614,250,1346,658,0,19137,688
Quảng Bình,2005,884,27,40823,17823,261,1581,727,0,23000,854
Quảng Bình,2006,921,27,42104,21408,286,1635,807,0,20696,828
Quảng Bình,2007,919,27,40123,20369,242,1678,892,0,19754,786
Quảng Bình,2008,880,28,39129,21475,312,1764,948,0,17654,816
Quảng Bình,2009,874,28,38184,20842,351,1774,982,0,17342,792
Quảng Bình,2010,852,27,36712,20119,329,1791,964,0,16593,827
Quảng Bình,2011,807,27,35221,18774,351,1774,1032,0,16447,742
Quảng Bình,2012,787,27,33169,17909,372,1759,1051,0,15260,708
Quảng Bình,2013,787,27,31270,16986,420,1742,1053,0,14284,689
Quảng Bình,2014,784,27,29919,16076,416,1761,1068,0,13843,693
Quảng Bình,2015,778,27,28403,15090,436,1788,1096,0,13313,692
Quảng Bình,2016,762,27,28921,15467,426,1780,1101,0,13454,679
Quảng Bình,2017,781,27,29770,15712,488,1744,1088,0,14058,656
Quảng Bình,2018,776,27,30438,16279,455,1564,1074,0,14159,490
Quảng Bình,2019,784,27,31999,17160,512,1661,1059,0,14839,602
Quảng Bình,2020,802,26,32618,17369,526,1764,1139,0,15249,625
Quảng Bình,2021,793,26,32095,16727,564,1754,1135,0,15368,619
Quảng Nam,2004,1199,39,58174,28685,1530,1823,981,8,29489,842
Quảng Nam,2005,1294,40,63540,30661,1857,1985,1002,14,32879,983
Quảng Nam,2006,1334,42,67470,34331,2977,2110,1193,26,33139,917
Quảng Nam,2007,1398,43,68260,35501,4255,2335,1292,35,32759,1043
Quảng Nam,2008,1361,43,64965,35837,4140,2546,1437,55,29128,1109
Quảng Nam,2009,1383,46,66711,35525,4566,2678,1758,63,31186,920
Quảng Nam,2010,1419,47,67572,36874,4691,2832,1669,69,30698,1163
Quảng Nam,2011,1437,49,67825,36292,5071,2827,1684,76,31533,1143
Quảng Nam,2012,1471,50,66303,33387,5546,2932,1774,82,32916,1158
Quảng Nam,2013,1431,50,61120,32722,5155,3027,1853,103,28398,1174
Quảng Nam,2014,1366,50,56303,30736,5188,3040,1866,122,25567,1174
Quảng Nam,2015,1347,50,54213,29310,5249,3059,1877,133,24903,1182
Quảng Nam,2016,1336,50,53285,29147,5327,2943,1827,150,24138,1116
Quảng Nam,2017,1346,51,51596,28493,5118,2838,1729,154,23103,1109
Quảng Nam,2018,1323,51,45812,25661,4277,2004,1671,148,20151,333
Quảng Nam,2019,1293,51,48801,27345,4720,2601,1613,141,21456,988
Quảng Nam,2020,1295,51,48554,27349,4769,2583,1606,142,21205,977
Quảng Nam,2021,1289,52,49872,27787,5009,2715,1723,156,22085,992
Quảng Ngãi,2004,997,29,46520,22409,1619,1831,937,38,24111,894
Quảng Ngãi,2005,1084,31,51465,25100,2116,1911,1015,43,26365,896
Quảng Ngãi,2006,1150,33,54991,27237,2448,2112,1166,50,27754,946
Quảng Ngãi,2007,1165,33,53424,25775,1833,2069,1091,37,27649,978
Quảng Ngãi,2008,1126,34,53472,29125,2186,2086,1120,54,24347,966
Quảng Ngãi,2009,1112,33,52694,29214,2214,2216,1219,61,23480,997
Quảng Ngãi,2010,1121,35,51235,28633,2490,2265,1253,54,22602,1012
Quảng Ngãi,2011,1121,35,50742,27978,3072,2289,1244,62,22764,1045
Quảng Ngãi,2012,1092,36,47397,26255,3489,2379,1315,71,21142,1064
Quảng Ngãi,2013,1032,37,42758,23345,3616,2403,1365,75,19413,1038
Quảng Ngãi,2014,982,37,39262,21514,3819,2368,1366,80,17748,1002
Quảng Ngãi,2015,957,37,37090,20473,4077,2317,1346,78,16617,971
Quảng Ngãi,2016,963,37,36906,20396,4302,2277,1326,75,16510,951
Quảng Ngãi,2017,956,36,36525,20440,4668,2176,1283,76,16085,893
Quảng Ngãi,2018,949,36,36227,20323,4658,2020,1297,82,15904,723
Quảng Ngãi,2019,935,36,36750,20610,4926,2170,1311,87,16140,859
Quảng Ngãi,2020,949,36,37882,21309,5059,2118,1283,87,16573,835
Quảng Ngãi,2021,964,36,38651,21602,5320,2112,1292,84,17049,820
Quảng Ninh,2004,916,33,40659,20540,3321,1637,1192,64,20119,445
Quảng Ninh,2005,999,37,44569,23049,3856,1705,1230,70,21520,475
Quảng Ninh,2006,1056,40,49430,24623,1365,1924,1283,59,24807,641
Quảng Ninh,2007,1065,45,47140,24853,4021,2025,1263,46,22287,762
Quảng Ninh,2008,1053,44,45596,24423,3842,2182,1499,76,21173,683
Quảng Ninh,2009,1026,44,44352,22482,3823,2255,1533,84,21870,722
Quảng Ninh,2010,1033,45,48492,25403,4640,2739,1877,114,23089,862
Quảng Ninh,2011,1027,46,42089,21609,3,2219,1563,0,20480,656
Quảng Ninh,2012,1031,46,40459,21003,3884,2368,1706,0,19456,662
Quảng Ninh,2013,1034,46,38724,18518,3720,2320,1569,107,20206,751
Quảng Ninh,2014,1016,47,36509,18792,3915,2342,1691,115,17717,651
Quảng Ninh,2015,1032,47,37718,18893,3841,2376,1751,110,18825,625
Quảng Ninh,2016,1047,46,37906,19385,3859,2321,1709,120,18521,612
Quảng Ninh,2017,1054,46,38144,19632,3791,2309,1715,132,18512,594
Quảng Ninh,2018,1058,44,38492,19544,3569,2452,1652,134,18948,800
Quảng Ninh,2019,1038,41,39334,20929,57,2134,1590,137,18405,544
Quảng Ninh,2020,1044,41,42443,21665,70,2141,1602,135,20778,539
Quảng Ninh,2021,1056,42,40973,21132,4331,2088,1563,134,19841,525
Quảng Trị,2004,598,24,25146,11983,715,1244,564,7,13163,680
Quảng Trị,2005,611,24,27068,13247,801,1328,609,4,13821,719
Quảng Trị,2006,651,25,29211,14530,865,1443,646,3,14681,797
Quảng Trị,2007,683,26,30187,15520,997,1624,763,5,14667,861
Quảng Trị,2008,703,29,30845,16372,1090,1637,797,5,14473,840
Quảng Trị,2009,742,29,31880,17059,1387,1882,932,5,14821,950
Quảng Trị,2010,703,31,30688,16506,1188,1750,902,18,14182,848
Quảng Trị,2011,680,30,29298,15641,1371,1635,889,24,13657,746
Quảng Trị,2012,676,30,28126,15017,1527,1488,810,31,13109,678
Quảng Trị,2013,658,30,26454,13960,1648,1529,865,23,12494,664
Quảng Trị,2014,658,30,25123,13201,1691,1529,870,24,11922,659
Quảng Trị,2015,648,29,23624,12485,1750,1529,879,24,11139,650
Quảng Trị,2016,647,27,23156,12207,1825,1532,893,23,10949,639
Quảng Trị,2017,645,27,23372,12433,2028,1518,883,20,10939,635
Quảng Trị,2018,690,26,24089,12486,1540,1874,884,18,11603,990
Quảng Trị,2019,649,25,24592,12369,2065,1494,886,17,12223,608
Quảng Trị,2020,662,24,24769,13065,2356,1537,921,17,11704,616
Quảng Trị,2021,658,24,24764,12999,2484,1540,925,16,11765,615
Sóc Trăng,2004,700,10,27813,12574,4841,1304,677,87,15239,627
Sóc Trăng,2005,746,14,29893,14111,5416,1393,719,83,15782,674
Sóc Trăng,2006,758,14,30174,14570,5512,1567,751,101,15604,816
Sóc Trăng,2007,752,15,28930,10361,5207,1721,819,126,18569,902
Sóc Trăng,2008,751,16,27695,13818,4582,1822,870,165,13877,952
Sóc Trăng,2009,754,17,27861,13899,4608,1775,847,160,13962,928
Sóc Trăng,2010,761,17,26609,13843,7590,1860,934,207,12766,926
Sóc Trăng,2011,795,18,27289,14137,5150,1853,982,162,13152,871
Sóc Trăng,2012,804,23,26824,13940,5925,1784,934,116,12884,850
Sóc Trăng,2013,815,22,26285,13260,6068,1947,826,246,13025,1121
Sóc Trăng,2014,755,23,26081,13414,6633,1933,1044,271,12667,889
Sóc Trăng,2015,760,24,26164,13622,6589,1888,1020,293,12542,868
Sóc Trăng,2016,703,24,27166,14258,6675,1883,1011,308,12908,872
Sóc Trăng,2017,709,24,27164,14331,6718,1870,1008,295,12833,862
Sóc Trăng,2018,714,24,16847,14211,6514,1820,987,314,2636,833
Sóc Trăng,2019,730,24,27539,14938,6862,1794,966,332,12601,828
Sóc Trăng,2020,736,24,28611,15469,7767,1756,947,313,13142,809
Sóc Trăng,2021,752,24,29771,16141,7911,1750,954,324,13630,796
Sơn La,2004,582,20,25826,10937,16868,908,502,187,14889,406
Sơn La,2005,681,23,30185,12750,20924,1120,619,198,17435,501
Sơn La,2006,762,26,32933,13943,23466,1253,823,288,18990,430
Sơn La,2007,768,26,31732,13866,22866,1357,763,250,17866,594
Sơn La,2008,714,26,30653,13801,20880,1494,831,276,16852,663
Sơn La,2009,645,28,28754,13106,21030,1557,899,286,15648,658
Sơn La,2010,713,29,30139,13863,21066,1584,920,332,16276,664
Sơn La,2011,732,30,29691,13269,22773,1545,907,354,16422,638
Sơn La,2012,680,31,28517,12440,20665,1590,943,375,16077,647
Sơn La,2013,668,31,27237,11789,20879,1615,950,399,15448,665
Sơn La,2014,674,31,26383,11464,20176,1599,965,388,14919,634
Sơn La,2015,695,32,27056,11968,20859,1567,940,375,15088,627
Sơn La,2016,680,32,27749,12552,21530,1517,924,378,15197,593
Sơn La,2017,707,32,29340,13847,22693,1505,918,378,15493,587
Sơn La,2018,750,31,30349,14663,23306,1547,954,398,15686,593
Sơn La,2019,826,30,36170,27763,8005,1654,989,418,8407,665
Sơn La,2020,856,30,36437,17146,28778,1652,1017,428,19291,635
Sơn La,2021,802,30,34020,17292,26711,1552,957,384,16728,595
TP.Hồ Chí Minh,2004,3491,70,156122,80093,6112,6681,3918,0,76029,2763
TP.Hồ Chí Minh,2005,3640,72,163042,83030,4759,7123,4189,0,80012,2934
TP.Hồ Chí Minh,2006,3788,76,166962,83248,5175,7668,4379,0,83714,3289
TP.Hồ Chí Minh,2007,4042,81,174596,89256,5875,8313,4891,0,85340,3422
TP.Hồ Chí Minh,2008,4207,81,180719,92930,5223,8998,5283,0,87789,3715
TP.Hồ Chí Minh,2009,4414,82,183743,92253,9200,9914,5913,0,91490,4001
TP.Hồ Chí Minh,2010,5230,100,187605,92955,10218,8835,5272,0,94650,3563
TP.Hồ Chí Minh,2011,4728,132,191126,97283,11587,10979,6478,0,93843,4501
TP.Hồ Chí Minh,2012,4905,120,193954,97573,14507,11419,6765,0,96381,4654
TP.Hồ Chí Minh,2013,4743,120,185167,94302,12692,11755,7040,87,90865,4715
TP.Hồ Chí Minh,2014,4797,125,186289,94546,12177,11962,7243,106,91743,4719
TP.Hồ Chí Minh,2015,4947,123,192684,98203,12854,12184,7450,107,94481,4734
TP.Hồ Chí Minh,2016,5192,123,204506,104781,15125,12371,7535,111,99725,4836
TP.Hồ Chí Minh,2017,5299,120,208894,106985,13687,12635,7685,103,101909,4950
TP.Hồ Chí Minh,2018,5556,122,215424,110555,13073,8998,7510,178,104869,1488
TP.Hồ Chí Minh,2019,5765,123,226350,116488,13014,11705,7334,253,109862,4371
TP.Hồ Chí Minh,2020,5947,123,233740,120021,13072,12140,7641,275,113719,4499
TP.Hồ Chí Minh,2021,5915,124,232350,119246,12694,12005,7572,276,113104,4433
Thanh Hóa,2004,2916,92,144060,69212,18843,5112,2768,170,74848,2344
Thanh Hóa,2005,3178,95,156605,78600,20400,5565,2769,198,78005,2796
Thanh Hóa,2006,3244,100,158590,78559,20585,5748,3066,225,80031,2682
Thanh Hóa,2007,3366,101,155064,79046,21106,6175,3504,229,76018,2671
Thanh Hóa,2008,3138,102,148157,76452,19190,6230,3516,243,71705,2714
Thanh Hóa,2009,3038,102,143856,75084,18942,6086,3522,243,68772,2564
Thanh Hóa,2010,2960,104,134750,69192,19852,6137,3296,243,65558,2841
Thanh Hóa,2011,2871,104,128803,67315,19206,5815,3528,295,61488,2287
Thanh Hóa,2012,2685,104,116196,59968,18315,5154,2688,347,56228,2466
Thanh Hóa,2013,2498,101,107055,54893,17106,5547,3114,297,52162,2433
Thanh Hóa,2014,2239,101,97849,51708,16253,5433,3325,348,46141,2108
Thanh Hóa,2015,2267,101,95296,50425,15365,5561,3461,330,44871,2100
Thanh Hóa,2016,2336,100,96338,51759,14818,5499,3485,325,44579,2014
Thanh Hóa,2017,2430,101,98423,51802,15919,5406,3361,296,46621,2045
Thanh Hóa,2018,2463,94,100725,53903,16179,5057,3216,291,46822,1841
Thanh Hóa,2019,2450,86,101089,54056,15977,4992,3071,286,47033,1921
Thanh Hóa,2020,2446,88,100562,53812,17206,5269,3510,338,46750,1759
Thanh Hóa,2021,2427,87,99395,53429,17284,5230,3486,341,45966,1744
Thái Bình,2004,1203,39,61943,29929,0,2114,1309,0,32014,805
Thái Bình,2005,1278,39,69908,33896,0,2059,1243,0,36012,816
Thái Bình,2006,1291,40,69904,35674,0,2305,1377,0,34230,928
Thái Bình,2007,1357,41,69976,34328,0,2379,1395,0,35648,984
Thái Bình,2008,1322,41,67014,34177,0,2585,1546,0,32837,1039
Thái Bình,2009,1267,41,64265,33605,0,2798,1874,0,30660,924
Thái Bình,2010,1233,40,62382,30791,0,2461,1605,0,31591,856
Thái Bình,2011,1203,40,59685,29853,0,2448,1689,0,29832,759
Thái Bình,2012,1200,40,57138,31032,0,2371,1575,0,26106,796
Thái Bình,2013,1205,40,55774,27070,0,2467,1720,0,28704,747
Thái Bình,2014,1217,39,54623,28800,0,2593,1929,0,25823,664
Thái Bình,2015,1198,39,54771,28190,0,2363,1789,0,26581,574
Thái Bình,2016,1209,39,52203,27083,0,2423,1781,0,25120,642
Thái Bình,2017,1204,39,53472,27909,0,2472,1832,0,25563,640
Thái Bình,2018,1213,39,53000,27911,33,2109,1759,0,25089,350
Thái Bình,2019,1211,39,54501,28550,45,2205,1686,0,25951,519
Thái Bình,2020,1223,39,55043,28642,47,2222,1702,0,26401,520
Thái Bình,2021,1231,39,55048,28430,57,2167,1668,0,26618,499
Thái Nguyên,2004,834,23,38295,19471,9511,1628,1147,319,18824,481
Thái Nguyên,2005,872,24,41162,21590,10077,1740,1150,312,19572,590
Thái Nguyên,2006,875,26,41259,20479,10152,1712,1126,399,20780,586
Thái Nguyên,2007,872,27,39546,21970,10351,1836,1272,355,17576,564
Thái Nguyên,2008,845,32,37885,19170,8496,1629,1071,310,18715,558
Thái Nguyên,2009,868,33,37989,20282,8833,1717,1081,217,17707,636
Thái Nguyên,2010,859,32,36736,18116,1029,1696,1341,376,18620,355
Thái Nguyên,2011,875,31,37651,19884,11946,2117,1414,355,17767,703
Thái Nguyên,2012,857,30,34881,16634,7677,2084,1130,334,18247,954
Thái Nguyên,2013,760,30,33926,18505,10066,2043,1492,461,15421,551
Thái Nguyên,2014,838,29,33305,17936,9817,1942,1394,471,15369,548
Thái Nguyên,2015,838,29,33478,18176,10054,2014,1406,431,15302,608
Thái Nguyên,2016,914,29,33543,18647,10219,1942,1404,417,14896,538
Thái Nguyên,2017,851,31,34422,18963,10629,1962,1437,403,15459,525
Thái Nguyên,2018,859,32,35265,19520,10840,1986,1416,398,15745,570
Thái Nguyên,2019,873,32,35840,4718,8124,1901,1395,392,31122,506
Thái Nguyên,2020,878,32,36305,19854,11787,1841,1373,427,16451,468
Thái Nguyên,2021,866,32,36225,19755,12031,1817,1353,437,16470,464
Thừa Thiên Huế,2004,887,25,38311,18129,1458,2134,1128,24,20182,1006
Thừa Thiên Huế,2005,966,26,42117,20735,1497,1725,943,28,21382,782
Thừa Thiên Huế,2006,1032,27,45178,23461,1712,1842,987,43,21717,855
Thừa Thiên Huế,2007,1047,31,45359,22489,2769,2241,1254,47,22870,987
Thừa Thiên Huế,2008,1055,31,44871,24754,1562,2268,1260,43,20117,1008
Thừa Thiên Huế,2009,1073,34,44350,25019,1623,2396,1342,35,19331,1054
Thừa Thiên Huế,2010,1066,36,44980,25467,1785,2501,1435,37,19513,1066
Thừa Thiên Huế,2011,1112,38,45681,25882,2084,2420,1406,42,19799,1014
Thừa Thiên Huế,2012,1075,38,44421,24609,2070,2491,1455,46,19812,1036
Thừa Thiên Huế,2013,1050,37,41934,23321,2024,2501,1503,49,18613,998
Thừa Thiên Huế,2014,1024,37,39295,21866,1822,2489,1507,48,17429,982
Thừa Thiên Huế,2015,1018,37,37427,20675,1710,2435,1480,47,16752,955
Thừa Thiên Huế,2016,1017,38,36943,20457,1724,2441,1503,51,16486,938
Thừa Thiên Huế,2017,1008,38,36622,20166,1708,2444,1514,52,16456,930
Thừa Thiên Huế,2018,1002,37,37119,20437,1621,2183,1444,50,16682,739
Thừa Thiên Huế,2019,998,36,37920,20613,1436,2210,1375,48,17307,835
Thừa Thiên Huế,2020,998,36,38429,21110,1499,2244,1398,48,17319,846
Thừa Thiên Huế,2021,997,36,38109,20649,1434,2213,1383,47,17460,830
Tiền Giang,2004,1023,25,44346,23190,0,1592,818,0,21156,774
Tiền Giang,2005,1067,26,45939,24541,0,1860,1004,0,21398,856
Tiền Giang,2006,1085,29,45624,22199,0,1870,1026,0,23425,844
Tiền Giang,2007,1091,30,45661,24499,0,2043,1090,0,21162,953
Tiền Giang,2008,1049,29,43489,24321,0,2041,1131,0,19168,910
Tiền Giang,2009,1010,31,41297,23280,0,2096,1152,0,18017,944
Tiền Giang,2010,968,31,39007,23007,0,2190,1223,0,16000,967
Tiền Giang,2011,954,33,39324,23053,0,2170,1219,0,16271,951
Tiền Giang,2012,932,33,39899,22969,0,2157,1232,0,16930,925
Tiền Giang,2013,968,33,37874,22294,0,2144,1213,0,15580,931
Tiền Giang,2014,976,33,38155,22315,0,2142,1213,0,15840,929
Tiền Giang,2015,1027,33,38252,22548,0,2168,1216,0,15704,952
Tiền Giang,2016,1011,34,41157,24062,0,2152,1208,0,17095,944
Tiền Giang,2017,1025,34,41965,24223,0,2110,1166,0,17742,944
Tiền Giang,2018,1045,34,33191,25565,75,2000,1166,0,7626,834
Tiền Giang,2019,1070,33,44242,25432,85,2069,1165,0,18810,904
Tiền Giang,2020,1096,33,46456,26531,107,2080,1172,0,19925,908
Tiền Giang,2021,1082,33,44139,24822,110,2035,1154,0,19317,881
Trà Vinh,2004,759,16,30174,13986,6406,1517,737,163,16188,780
Trà Vinh,2005,761,19,30360,14588,6787,1576,768,180,15772,808
Trà Vinh,2006,695,21,27338,13047,5632,1695,833,199,14291,862
Trà Vinh,2007,656,22,24806,13019,5242,1786,864,207,11787,922
Trà Vinh,2008,658,24,23635,12320,5000,1823,899,233,11315,924
Trà Vinh,2009,599,27,19660,10635,3945,1742,771,355,9025,971
Trà Vinh,2010,584,28,18252,10160,3565,1754,865,220,8092,889
Trà Vinh,2011,544,28,17137,9677,3463,1706,845,224,7460,861
Trà Vinh,2012,557,28,17749,9434,3679,1697,841,229,8315,856
Trà Vinh,2013,585,28,17568,10282,3810,1673,809,214,7286,864
Trà Vinh,2014,603,28,17914,10536,4034,1685,830,223,7378,855
Trà Vinh,2015,629,29,18876,11122,4248,1689,843,234,7754,846
Trà Vinh,2016,607,29,20562,12088,4627,1677,845,235,8474,832
Trà Vinh,2017,639,29,21394,12524,4686,1681,857,239,8870,824
Trà Vinh,2018,649,29,30422,13193,5375,1685,858,254,17229,827
Trà Vinh,2019,700,29,25188,14057,6187,1710,859,270,11131,851
Trà Vinh,2020,732,29,27232,14818,6886,1635,829,252,12414,806
Trà Vinh,2021,749,29,28370,15384,7634,1588,806,252,12986,782
Tuyên Quang,2004,706,13,38876,17754,17786,1415,880,261,21122,535
Tuyên Quang,2005,923,28,40788,20226,20206,1595,989,323,20562,606
Tuyên Quang,2006,905,28,38814,20085,18927,1683,1045,336,18729,638
Tuyên Quang,2007,791,28,30667,17124,14968,1603,962,318,13543,641
Tuyên Quang,2008,722,28,28099,15567,14286,1586,993,327,12532,593
Tuyên Quang,2009,711,28,27364,14695,14157,1549,991,315,12669,558
Tuyên Quang,2010,676,28,26568,14164,13747,1505,962,322,12404,543
Tuyên Quang,2011,662,28,26006,13427,13806,1491,955,332,12579,536
Tuyên Quang,2012,650,28,24537,12637,13391,1464,942,341,11900,522
Tuyên Quang,2013,652,29,23735,12063,13140,1450,929,337,11672,521
Tuyên Quang,2014,645,29,22709,11604,12661,1409,922,322,11105,487
Tuyên Quang,2015,637,29,22830,11801,12527,1448,950,314,11029,498
Tuyên Quang,2016,627,29,22977,11985,12891,1383,905,320,10992,478
Tuyên Quang,2017,626,29,23076,12093,12704,1366,900,311,10983,466
Tuyên Quang,2018,661,29,24083,12677,13450,1118,910,321,11406,208
Tuyên Quang,2019,623,29,24371,12794,13738,1376,920,331,11577,456
Tuyên Quang,2020,628,29,24578,12965,14118,1368,950,325,11613,418
Tuyên Quang,2021,640,26,25011,13149,14443,1348,947,315,11862,401
Tây Ninh,2004,604,28,26340,10638,73,864,461,0,15702,403
Tây Ninh,2005,652,29,27288,14422,116,984,542,0,12866,442
Tây Ninh,2006,625,30,26921,12962,122,1127,623,0,13959,504
Tây Ninh,2007,619,30,27826,15643,141,1156,594,0,12183,562
Tây Ninh,2008,647,31,27032,15109,146,1286,677,0,11923,609
Tây Ninh,2009,649,31,27495,15334,157,1375,745,0,12161,630
Tây Ninh,2010,677,31,27024,15191,147,1410,768,0,11833,642
Tây Ninh,2011,661,31,26331,14570,183,1369,734,0,11761,635
Tây Ninh,2012,644,30,25148,14063,39,1405,768,0,11085,637
Tây Ninh,2013,625,30,24470,13397,222,1378,762,0,11073,616
Tây Ninh,2014,618,30,23848,13125,256,1425,805,0,10723,620
Tây Ninh,2015,629,30,24545,13471,230,1415,797,0,11074,618
Tây Ninh,2016,653,30,26167,14457,224,1417,796,0,11710,621
Tây Ninh,2017,668,31,26850,14788,284,1409,785,0,12062,624
Tây Ninh,2018,673,28,27197,15163,277,1365,778,0,12034,587
Tây Ninh,2019,691,26,27990,15598,294,1361,772,0,12392,589
Tây Ninh,2020,712,26,29061,16289,385,1371,782,0,12772,589
Tây Ninh,2021,728,26,29647,16666,388,1380,796,0,12981,584
Vĩnh Long,2004,967,10,38431,18905,479,1453,845,0,19526,608
Vĩnh Long,2005,999,15,39522,19899,642,1723,1013,0,19623,710
Vĩnh Long,2006,981,16,38130,18674,592,1910,1139,0,19456,771
Vĩnh Long,2007,936,19,37068,18967,600,2118,1265,0,18101,853
Vĩnh Long,2008,903,20,35126,18097,495,2136,1253,0,17029,883
Vĩnh Long,2009,869,21,34044,17688,512,2174,1276,0,16356,898
Vĩnh Long,2010,846,21,32880,17157,470,2196,1323,0,15723,873
Vĩnh Long,2011,825,22,32238,16966,452,2190,1230,0,15272,960
Vĩnh Long,2012,818,23,30527,16629,448,2170,1309,0,13898,861
Vĩnh Long,2013,804,23,28035,15145,401,2135,1273,0,12890,862
Vĩnh Long,2014,798,23,27598,14980,417,2067,1236,0,12618,831
Vĩnh Long,2015,813,23,27796,15098,423,2029,1222,0,12698,807
Vĩnh Long,2016,855,23,29680,16090,431,2060,1243,0,13590,817
Vĩnh Long,2017,897,24,29956,16185,460,2056,1248,24,13771,808
Vĩnh Long,2018,863,24,41598,16421,501,2018,1228,26,25177,790
Vĩnh Long,2019,867,24,29672,16204,603,1988,1209,29,13468,779
Vĩnh Long,2020,861,24,29611,16170,563,1966,1202,31,13441,764
Vĩnh Long,2021,867,24,29702,16001,601,1956,1200,33,13701,756
Vĩnh Phúc,2004,988,38,47265,21649,1122,1909,1117,0,25616,792
Vĩnh Phúc,2005,1014,38,48394,23122,1259,2026,1186,0,25272,840
Vĩnh Phúc,2006,1036,43,48695,23367,1382,1993,1228,0,25328,765
Vĩnh Phúc,2007,1065,43,48468,24510,1310,2182,1361,0,23958,821
Vĩnh Phúc,2008,922,37,40879,20295,2256,1900,1221,0,20584,679
Vĩnh Phúc,2009,906,38,39113,16742,1525,1827,1272,0,22371,555
Vĩnh Phúc,2010,878,36,37416,15815,1318,1999,1435,0,21601,564
Vĩnh Phúc,2011,846,36,35537,19192,1,2059,1507,0,16345,552
Vĩnh Phúc,2012,847,37,33722,18348,1328,2014,1421,0,15374,593
Vĩnh Phúc,2013,842,37,31260,17391,1332,2102,1569,58,13869,533
Vĩnh Phúc,2014,811,37,28802,15925,1294,2054,1544,58,12877,510
Vĩnh Phúc,2015,809,37,28065,15699,1351,2079,1549,48,12366,530
Vĩnh Phúc,2016,807,37,28096,15529,1268,2015,1523,34,12567,492
Vĩnh Phúc,2017,810,34,28418,15910,1300,1973,1492,45,12508,481
Vĩnh Phúc,2018,776,32,29443,16335,1357,1887,1456,59,13108,431
Vĩnh Phúc,2019,776,31,30326,20126,4018,1871,1419,73,10200,452
Vĩnh Phúc,2020,819,29,40427,20705,4235,1860,1414,72,19722,446
Vĩnh Phúc,2021,843,29,33463,18312,1543,1841,1399,75,15151,442
Yên Bái,2004,612,21,26777,12501,10409,1077,773,122,14276,304
Yên Bái,2005,698,21,30298,14176,12122,1173,782,141,16122,391
Yên Bái,2006,720,21,31192,14823,12714,1294,873,148,16369,421
Yên Bái,2007,646,22,25456,12911,9772,1369,905,156,12545,464
Yên Bái,2008,584,23,21933,11431,8143,1383,918,207,10502,465
Yên Bái,2009,535,24,20523,10800,7591,1382,925,198,9723,457
Yên Bái,2010,540,24,20869,10901,8067,1313,887,218,9968,426
Yên Bái,2011,536,24,20747,10492,8236,1340,781,212,10255,559
Yên Bái,2012,515,24,19800,9807,8421,1259,861,205,9993,398
Yên Bái,2013,503,24,18931,9395,8442,1261,816,221,9536,445
Yên Bái,2014,488,24,18363,9160,8325,1230,836,223,9203,394
Yên Bái,2015,482,24,18568,9393,8612,1190,809,218,9175,381
Yên Bái,2016,475,24,18765,9523,8561,1143,789,201,9242,354
Yên Bái,2017,473,24,19245,9819,8672,1102,760,201,9426,342
Yên Bái,2018,471,24,19689,10170,8657,1045,739,202,9519,306
Yên Bái,2019,477,24,20269,7371,14251,1040,718,202,12898,322
Yên Bái,2020,482,24,20759,10807,9681,1019,706,197,9952,313
Yên Bái,2021,493,23,21153,11126,10206,1005,695,198,10027,310
Điện Biên,2004,292,16,11976,4793,6744,539,352,38,7183,187
Điện Biên,2005,344,16,14135,5609,8888,670,445,61,8526,225
Điện Biên,2006,381,18,14561,6202,9276,738,407,55,8359,331
Điện Biên,2007,386,18,14462,6821,10579,891,452,67,7641,439
Điện Biên,2008,388,21,14193,5312,8800,874,541,52,8881,333
Điện Biên,2009,389,28,14026,6080,10000,998,633,79,7946,365
Điện Biên,2010,437,28,14504,6019,10051,1045,647,95,8485,398
Điện Biên,2011,469,29,15449,6421,11657,1049,650,98,9028,399
Điện Biên,2012,487,28,15751,6343,11992,1143,695,101,9408,448
Điện Biên,2013,501,28,15877,6315,12216,1173,735,175,9562,438
Điện Biên,2014,504,31,15384,6101,12042,1157,702,167,9283,455
Điện Biên,2015,505,31,15194,6465,12299,1190,751,190,8729,439
Điện Biên,2016,498,21,15753,6434,12372,1182,753,183,9319,429
Điện Biên,2017,507,21,16394,6629,12882,1178,758,191,9765,420
Điện Biên,2018,514,25,16632,6849,13114,1190,763,213,9783,427
Điện Biên,2019,512,29,17931,6959,11239,1191,768,235,10972,423
Điện Biên,2020,524,29,19043,8088,15119,1179,764,230,10955,415
Điện Biên,2021,517,29,20107,8660,16077,1212,781,252,11447,431
Đà Nẵng,2004,605,16,29522,15613,0,1228,798,0,13909,430
Đà Nẵng,2005,667,17,32187,16965,0,1410,936,0,15222,474
Đà Nẵng,2006,695,19,33773,16856,74,1496,1007,0,16917,489
Đà Nẵng,2007,715,19,34320,18168,0,1588,1102,0,16152,486
Đà Nẵng,2008,712,20,34177,18454,0,1616,1142,0,15723,474
Đà Nẵng,2009,716,20,33657,18352,0,1629,1150,0,15305,479
Đà Nẵng,2010,679,20,34022,18531,0,1686,1208,0,15491,478
Đà Nẵng,2011,729,19,34076,18257,0,1690,1225,0,15819,465
Đà Nẵng,2012,738,20,33673,18361,0,1691,1209,0,15312,482
Đà Nẵng,2013,730,20,30987,16403,0,1701,1212,0,14584,489
Đà Nẵng,2014,724,20,29608,15447,0,1710,1255,0,14161,455
Đà Nẵng,2015,725,22,28947,15222,0,1694,1245,0,13725,449
Đà Nẵng,2016,753,23,29396,15736,0,1737,1274,0,13660,463
Đà Nẵng,2017,765,22,29574,15662,0,1790,1326,0,13912,464
Đà Nẵng,2018,796,23,30500,16246,123,1696,1356,0,14254,340
Đà Nẵng,2019,859,24,32491,17191,167,1828,1386,0,15300,442
Đà Nẵng,2020,910,24,34632,18541,143,1989,1523,0,16091,466
Đà Nẵng,2021,931,24,34980,18743,119,2041,1555,0,16237,486
Đắk Lắk,2004,1312,26,63958,31974,10148,2060,848,89,31984,1212
Đắk Lắk,2005,1611,29,74958,38688,13397,2251,997,88,36270,1254
Đắk Lắk,2006,1701,32,80432,40447,15862,2692,1330,108,39985,1362
Đắk Lắk,2007,1771,40,79709,43770,15197,3152,1466,142,35939,1686
Đắk Lắk,2008,1791,47,76020,43934,13044,3212,1535,133,32086,1677
Đắk Lắk,2009,1659,49,70216,36673,11612,3397,1798,198,33543,1599
Đắk Lắk,2010,1643,52,71664,37007,12165,3473,1830,215,34657,1643
Đắk Lắk,2011,1654,52,71521,36474,13278,3561,1852,219,35047,1709
Đắk Lắk,2012,1656,52,71514,37787,13463,3505,1924,223,33727,1581
Đắk Lắk,2013,1651,52,68919,39161,13853,3893,1866,239,29758,2027
Đắk Lắk,2014,1616,52,64095,36026,13972,3582,2027,266,28069,1555
Đắk Lắk,2015,1626,52,63766,35638,14075,3560,1987,267,28128,1573
Đắk Lắk,2016,1631,52,62607,35229,13276,3575,2042,283,27378,1533
Đắk Lắk,2017,1588,52,60780,33918,13087,3587,2056,274,26862,1531
Đắk Lắk,2018,1576,52,57864,31944,12185,2711,2020,272,25920,691
Đắk Lắk,2019,1584,53,58718,32284,13153,3425,1983,270,26434,1442
Đắk Lắk,2020,1587,53,59797,33139,13131,3369,1959,267,26658,1410
Đắk Lắk,2021,1595,54,60894,33668,13591,3393,2001,278,27226,1392
Đắk Nông,2004,244,8,10624,5090,1357,357,172,16,5534,185
Đắk Nông,2005,319,8,7550,4102,524,445,213,12,3448,232
Đắk Nông,2006,366,12,13460,6795,1355,568,281,21,6665,287
Đắk Nông,2007,432,16,16408,9331,3246,784,405,18,7077,379
Đắk Nông,2008,419,18,16754,9005,3071,887,424,35,7749,463
Đắk Nông,2009,434,18,17857,9289,3181,935,540,49,8568,395
Đắk Nông,2010,453,19,17298,9598,3321,1075,612,72,7700,463
Đắk Nông,2011,468,22,18160,9947,3654,1100,586,74,8213,514
Đắk Nông,2012,475,24,18355,9915,3531,1091,599,75,8440,492
Đắk Nông,2013,481,23,18179,9863,3811,1168,658,83,8316,510
Đắk Nông,2014,494,23,17966,9835,3950,1199,680,84,8131,519
Đắk Nông,2015,503,24,18307,10203,4097,1209,684,82,8104,525
Đắk Nông,2016,513,24,18962,10516,4194,1211,721,86,8446,490
Đắk Nông,2017,521,25,19107,10537,4200,1205,720,89,8570,485
Đắk Nông,2018,525,24,19273,10565,4216,1186,724,94,8708,462
Đắk Nông,2019,516,24,20078,10865,4569,1216,729,100,9213,487
Đắk Nông,2020,529,24,21133,11290,4829,1206,726,102,9843,480
Đắk Nông,2021,541,24,21970,11717,5077,1192,721,98,10253,471
Đồng Nai,2004,1536,45,72011,38343,1337,2257,1218,0,33668,1039
Đồng Nai,2005,1633,50,78817,39772,1361,2545,1297,0,39045,1248
Đồng Nai,2006,1698,47,81549,41405,1667,2886,1600,18,40144,1286
Đồng Nai,2007,1749,48,80966,39763,1671,3054,1675,23,41203,1379
Đồng Nai,2008,1756,46,79848,45516,1778,3300,1711,39,34332,1589
Đồng Nai,2009,1753,43,76316,45161,1872,3599,1937,64,31155,1662
Đồng Nai,2010,1784,48,78708,42738,1785,3687,1997,93,35970,1690
Đồng Nai,2011,1811,48,78076,43159,4315,3860,2193,62,34917,1667
Đồng Nai,2012,1797,50,77582,43237,3554,3828,2166,30,34345,1662
Đồng Nai,2013,1771,50,73152,40138,4493,3817,1811,33,33014,2006
Đồng Nai,2014,1882,47,70403,38562,4277,3917,2302,33,31841,1615
Đồng Nai,2015,1817,47,71058,40106,4191,3956,2337,39,30952,1619
Đồng Nai,2016,1844,48,73381,41889,3848,3898,2313,42,31492,1585
Đồng Nai,2017,1886,49,74830,42039,3947,3996,2371,40,32791,1625
Đồng Nai,2018,1874,50,72795,41003,3776,3360,2323,58,31792,1037
Đồng Nai,2019,1916,51,77365,43283,3865,3760,2275,77,34082,1485
Đồng Nai,2020,1953,50,79968,44715,3941,3776,2302,76,35253,1474
Đồng Nai,2021,1987,50,82334,45421,4168,3928,2411,76,36913,1517
Đồng Tháp,2004,991,24,40694,19604,0,1875,848,0,21090,1027
Đồng Tháp,2005,1055,36,43185,20840,0,2114,990,0,22345,1124
Đồng Tháp,2006,1111,37,45301,22777,0,2270,1006,0,22524,1264
Đồng Tháp,2007,1107,39,45109,23945,0,2350,1114,0,21164,1236
Đồng Tháp,2008,1148,40,46415,19612,0,2434,1165,0,26803,1269
Đồng Tháp,2009,1140,42,44819,23818,0,2812,1465,0,21001,1347
Đồng Tháp,2010,1086,40,41750,21964,0,2704,1416,0,19786,1288
Đồng Tháp,2011,1049,41,39039,21352,0,2544,1324,0,17687,1220
Đồng Tháp,2012,1059,40,39847,21815,0,2541,1325,0,18032,1216
Đồng Tháp,2013,1052,40,38410,19903,0,2511,1308,0,18507,1203
Đồng Tháp,2014,1055,40,38254,20306,0,2482,1296,0,17948,1186
Đồng Tháp,2015,1043,40,38538,20343,0,2465,1293,0,18195,1172
Đồng Tháp,2016,1061,40,40084,21517,0,2421,1269,0,18567,1152
Đồng Tháp,2017,1069,39,40230,21500,0,2453,1244,0,18730,1209
Đồng Tháp,2018,1071,38,46737,22591,37,2417,1259,0,24146,1158
Đồng Tháp,2019,1087,37,42026,23094,41,2407,1274,0,18932,1133
Đồng Tháp,2020,1144,37,44115,23946,35,2445,1299,0,20169,1146
Đồng Tháp,2021,1175,36,45511,24529,39,2476,1321,0,20982,1155
