Địa phương,Năm,Học sinh dân tộc thiểu số,Trường,Lớp,Học sinh,Giáo viên,Giáo viên nữ,Học sinh nữ,Giáo viên dân tộc thiểu số,Học sinh nam,Giáo viên nam
An Giang,2004,11557,400,6698,198452,7765,4418,95622,207,102830,3347
An Giang,2005,10967,400,6443,186459,7645,4240,90124,219,96335,3405
An Giang,2006,10068,395,6366,181411,7146,4197,85727,181,95684,2949
An Giang,2007,9553,392,6267,176887,7834,4333,82864,213,94023,3501
An Giang,2008,9836,395,6159,173058,7401,4250,83900,200,89158,3151
An Giang,2009,10064,393,6271,177594,7746,4364,85418,206,92176,3382
An Giang,2010,10503,396,6366,182857,7969,4533,88471,218,94386,3436
An Giang,2011,10614,390,6448,186167,8060,4619,89747,244,96420,3441
An Giang,2012,10550,392,6527,188425,8493,4866,91404,271,97021,3627
An Giang,2013,10608,357,6579,193255,8747,5009,93762,287,99493,3738
An Giang,2014,10680,346,6664,196431,8983,5188,94924,290,101507,3795
An Giang,2015,10932,339,6673,199045,8932,5124,96221,301,102824,3808
An Giang,2016,10953,334,6605,192524,8856,4977,92888,301,99636,3879
An Giang,2017,11157,328,6562,189176,8836,5091,91344,296,97832,3745
An Giang,2018,11535,325,6503,163904,9120,5098,92512,302,71392,4022
An Giang,2019,11966,322,6413,188619,8748,5106,91092,309,97527,3642
An Giang,2020,11896,319,6244,180505,8675,5081,87125,312,93380,3594
An Giang,2021,11873,312,6149,176816,8594,5043,85694,321,91122,3551
Bà Rịa - Vũng Tàu,2004,1908,139,2936,91690,3551,3017,43974,0,47716,534
Bà Rịa - Vũng Tàu,2005,1884,139,2882,87509,3649,3079,41932,0,45577,570
Bà Rịa - Vũng Tàu,2006,1948,142,2852,85747,3665,3092,41848,0,43899,573
Bà Rịa - Vũng Tàu,2007,1948,143,2819,84427,3639,3063,40554,0,43873,576
Bà Rịa - Vũng Tàu,2008,2186,141,2830,84285,3862,3272,40959,0,43326,590
Bà Rịa - Vũng Tàu,2009,2259,140,2869,88051,3898,3292,42497,0,45554,606
Bà Rịa - Vũng Tàu,2010,2305,145,2983,90716,4098,3453,43715,0,47001,645
Bà Rịa - Vũng Tàu,2011,2240,144,3023,91387,4067,3455,43899,0,47488,612
Bà Rịa - Vũng Tàu,2012,2361,143,3035,92882,4069,3418,44432,0,48450,651
Bà Rịa - Vũng Tàu,2013,2508,144,3116,95720,4238,3589,45851,0,49869,649
Bà Rịa - Vũng Tàu,2014,2733,146,3171,98336,4395,3761,46732,0,51604,634
Bà Rịa - Vũng Tàu,2015,2762,142,3187,100255,4396,3775,48048,0,52207,621
Bà Rịa - Vũng Tàu,2016,2783,143,3219,98290,4398,3561,46862,0,51428,837
Bà Rịa - Vũng Tàu,2017,2918,143,3400,102399,4449,3809,49077,32,53322,640
Bà Rịa - Vũng Tàu,2018,3219,140,3203,109327,4512,3828,52185,36,57142,684
Bà Rịa - Vũng Tàu,2019,3346,136,3214,112351,4458,3846,53684,39,58667,612
Bà Rịa - Vũng Tàu,2020,3476,134,3245,113851,4439,3835,54315,39,59536,604
Bà Rịa - Vũng Tàu,2021,3624,136,3307,118820,4467,3858,57243,49,61577,609
Bình Dương,2004,0,122,2459,69837,3383,2754,32398,0,37439,629
Bình Dương,2005,0,129,2433,69105,3296,2690,32902,0,36203,606
Bình Dương,2006,531,131,2422,71253,3294,2706,33942,0,37311,588
Bình Dương,2007,703,131,2423,73713,3247,2649,35023,0,38690,598
Bình Dương,2008,727,129,2516,76576,3223,2649,37256,0,39320,574
Bình Dương,2009,901,129,2698,85357,3553,2858,40839,0,44518,695
Bình Dương,2010,1353,133,2769,92435,3638,2996,44140,0,48295,642
Bình Dương,2011,1075,136,3057,100924,3801,3143,48295,0,52629,658
Bình Dương,2012,1471,136,3107,110134,4182,3442,52658,0,57476,740
Bình Dương,2013,1887,136,3370,123441,4868,3583,58837,0,64604,1285
Bình Dương,2014,2298,139,3597,135468,5255,4417,64660,0,70808,838
Bình Dương,2015,2875,145,4046,151738,5586,4724,72087,0,79651,862
Bình Dương,2016,3645,151,4117,157396,5919,4397,75040,0,82356,1522
Bình Dương,2017,4774,152,4521,172503,6209,5295,82389,0,90114,914
Bình Dương,2018,6835,150,4647,193811,6361,5342,92713,0,101098,1019
Bình Dương,2019,7926,149,4897,205273,6308,5388,98151,0,107122,920
Bình Dương,2020,8547,154,5030,211122,6558,5609,100759,0,110363,949
Bình Dương,2021,9104,158,5312,221591,6614,5663,106277,0,115314,951
Bình Phước,2004,21417,142,3483,92287,4242,3676,44037,144,48250,566
Bình Phước,2005,21699,144,3330,91412,4301,3629,43733,140,47679,672
Bình Phước,2006,10207,148,3352,90017,4232,3636,43087,152,46930,596
Bình Phước,2007,21627,152,3394,89938,4396,3719,42483,152,47455,677
Bình Phước,2008,21339,159,3446,89514,4546,3819,42808,197,46706,727
Bình Phước,2009,19230,163,3469,91020,4637,3676,41688,191,49332,961
Bình Phước,2010,22160,166,3629,91869,4715,3883,44440,235,47429,832
Bình Phước,2011,22101,169,3608,92149,4559,3777,44119,266,48030,782
Bình Phước,2012,22100,172,3590,93195,4631,3782,44636,297,48559,849
Bình Phước,2013,22233,171,3772,95380,4862,3950,45783,335,49597,912
Bình Phước,2014,22026,173,3683,97312,4904,4018,46708,340,50604,886
Bình Phước,2015,21480,173,3653,99150,5005,4119,47854,380,51296,886
Bình Phước,2016,20719,173,3625,96877,5027,4087,46619,398,50258,940
Bình Phước,2017,20091,174,3574,97441,4935,4066,47147,399,50294,869
Bình Phước,2018,20625,156,3548,101500,5047,4057,48974,401,52526,990
Bình Phước,2019,21102,137,3546,102260,4964,4048,49402,403,52858,916
Bình Phước,2020,21393,123,3509,102551,4866,3971,49514,411,53037,895
Bình Phước,2021,21835,122,3532,106761,4787,3910,51661,402,55100,877
Bình Thuận,2004,12590,269,4579,139610,5558,4644,67542,189,72068,914
Bình Thuận,2005,11674,273,4385,128187,5471,4553,61978,184,66209,918
Bình Thuận,2006,10787,274,4193,119310,5254,4436,57708,183,61602,818
Bình Thuận,2007,10521,274,4084,113571,5259,4450,54567,210,59004,809
Bình Thuận,2008,10383,278,4049,109348,5226,4405,52635,190,56713,821
Bình Thuận,2009,10250,281,4288,109631,5295,4442,52999,151,56632,853
Bình Thuận,2010,10195,282,4388,110160,5395,4501,53503,221,56657,894
Bình Thuận,2011,10371,281,4132,109677,5394,4494,53005,234,56672,900
Bình Thuận,2012,10230,279,4106,109862,5472,4547,53335,246,56527,925
Bình Thuận,2013,10269,280,4138,111456,5716,4713,54030,281,57426,1003
Bình Thuận,2014,10246,280,4127,111499,5760,4757,53882,303,57617,1003
Bình Thuận,2015,10406,278,4150,112737,5886,4821,54598,312,58139,1065
Bình Thuận,2016,10252,277,4014,109946,5895,4639,53198,333,56748,1256
Bình Thuận,2017,10418,277,4040,111050,5860,4823,53850,332,57200,1037
Bình Thuận,2018,11317,262,4175,116574,5802,4861,56416,356,60158,941
Bình Thuận,2019,11215,248,4155,118162,5971,4899,57323,381,60839,1072
Bình Thuận,2020,11442,246,4169,119334,5905,4848,57810,407,61524,1057
Bình Thuận,2021,11819,242,4247,124379,5844,4788,60387,406,63992,1056
Bình Định,2004,4830,241,5289,158052,6084,4255,75187,0,82865,1829
Bình Định,2005,3360,242,4995,145941,5973,4424,70143,0,75798,1549
Bình Định,2006,4088,240,4836,138173,5717,4136,66403,0,71770,1581
Bình Định,2007,3537,242,4704,132053,5852,4215,63499,0,68554,1637
Bình Định,2008,3387,242,4601,126274,5886,4234,60886,0,65388,1652
Bình Định,2009,3349,243,4630,124688,5889,4268,60455,0,64233,1621
Bình Định,2010,3460,241,4628,125353,5980,4318,60692,0,64661,1662
Bình Định,2011,3545,241,4613,122878,6049,4357,59741,0,63137,1692
Bình Định,2012,3669,243,4555,122763,6239,4402,58973,0,63790,1837
Bình Định,2013,3826,243,4734,124142,6261,4433,59838,81,64304,1828
Bình Định,2014,3934,244,4532,123943,6278,4531,59662,79,64281,1747
Bình Định,2015,4053,243,4510,124805,6338,4597,60123,90,64682,1741
Bình Định,2016,4131,243,4454,119614,6286,4168,57597,86,62017,2118
Bình Định,2017,4199,244,4433,120003,6176,4526,57935,90,62068,1650
Bình Định,2018,4383,226,4347,123403,6301,4388,59558,82,63845,1913
Bình Định,2019,4481,208,4207,121423,5694,4249,58612,75,62811,1445
Bình Định,2020,4645,204,4279,122715,6062,4454,59164,82,63551,1608
Bình Định,2021,4733,204,4334,129160,5963,4400,62369,93,66791,1563
Bạc Liêu,2004,1716,150,3315,85879,4004,2244,34305,173,51574,1760
Bạc Liêu,2005,7319,150,3073,79033,3933,2041,37405,140,41628,1892
Bạc Liêu,2006,7306,150,3048,75893,4536,2359,36215,163,39678,2177
Bạc Liêu,2007,5284,150,2920,75006,3720,2097,32938,140,42068,1623
Bạc Liêu,2008,7146,154,2886,75497,3468,1956,36145,155,39352,1512
Bạc Liêu,2009,6992,154,2895,79050,3484,1962,38158,128,40892,1522
Bạc Liêu,2010,7522,154,2911,81784,3550,2001,39380,142,42404,1549
Bạc Liêu,2011,7557,154,2869,82291,3495,1942,39002,136,43289,1553
Bạc Liêu,2012,7629,151,2781,81211,3615,1975,39012,130,42199,1640
Bạc Liêu,2013,7420,142,2607,79945,3484,1915,38527,138,41418,1569
Bạc Liêu,2014,7236,130,2559,78258,3334,1866,37657,130,40601,1468
Bạc Liêu,2015,8333,127,2512,76519,3357,1889,36762,132,39757,1468
Bạc Liêu,2016,8145,128,2450,73050,3258,1844,35191,136,37859,1414
Bạc Liêu,2017,8296,129,2448,73166,3281,1884,35371,134,37795,1397
Bạc Liêu,2018,8636,130,2450,113580,3308,1837,36787,136,76793,1471
Bạc Liêu,2019,8831,131,2412,76171,3149,1790,36983,138,39188,1359
Bạc Liêu,2020,8914,118,2336,74721,3091,1750,36295,144,38426,1341
Bạc Liêu,2021,8147,115,2289,74084,3020,1714,36061,137,38023,1306
Bắc Giang,2004,21215,256,5356,142383,7731,6621,59399,416,82984,1110
Bắc Giang,2005,22460,255,5135,130213,7379,6324,63322,428,66891,1055
Bắc Giang,2006,21191,256,4979,124713,6987,6165,61707,425,63006,822
Bắc Giang,2007,16487,258,4843,123233,7342,6115,58299,320,64934,1227
Bắc Giang,2008,19441,260,4816,120102,6980,5948,55771,392,64331,1032
Bắc Giang,2009,19595,259,5001,120173,7052,5959,57753,394,62420,1093
Bắc Giang,2010,20184,258,5102,119595,7013,6068,57690,477,61905,945
Bắc Giang,2011,19114,259,5294,119168,6981,6055,57039,521,62129,926
Bắc Giang,2012,18883,259,4950,120340,7312,6301,57312,565,63028,1011
Bắc Giang,2013,19330,260,4982,124948,7385,6374,59185,623,65763,1011
Bắc Giang,2014,19360,260,4970,127048,7352,6334,59897,646,67151,1018
Bắc Giang,2015,20381,261,5041,133223,7368,6350,62533,659,70690,1018
Bắc Giang,2016,22150,260,5115,139524,7370,6378,64962,668,74562,992
Bắc Giang,2017,23790,247,5219,145661,7439,6409,67603,736,78058,1030
Bắc Giang,2018,26776,234,5311,158791,7477,6538,73659,810,85132,939
Bắc Giang,2019,29462,222,5515,169613,7658,6668,78618,884,90995,990
Bắc Giang,2020,31798,220,5692,177935,7946,6918,82221,1004,95714,1028
Bắc Giang,2021,34274,220,5793,187428,7863,6849,86570,1038,100858,1014
Bắc Kạn,2004,27651,111,1613,30155,1803,1529,14272,1594,15883,274
Bắc Kạn,2005,24826,111,1542,27413,1749,1467,12912,1529,14501,282
Bắc Kạn,2006,22400,108,1410,24735,1750,1468,11650,153,13085,282
Bắc Kạn,2007,21767,108,1434,23401,1752,1433,11569,1530,11832,319
Bắc Kạn,2008,20871,99,1703,22686,1786,1478,11116,1753,11570,308
Bắc Kạn,2009,20035,107,1456,22665,2002,1639,10597,1868,12068,363
Bắc Kạn,2010,20946,110,1504,22971,2094,1696,10990,1883,11981,398
Bắc Kạn,2011,21001,111,1555,23007,1984,1608,10985,1903,12022,376
Bắc Kạn,2012,21007,112,1587,22988,2141,1754,10964,1923,12024,387
Bắc Kạn,2013,21491,111,1488,23525,2183,1763,11303,1962,12222,420
Bắc Kạn,2014,21529,112,1490,23540,2194,1749,11330,1979,12210,445
Bắc Kạn,2015,21843,113,1489,23901,2233,1740,11598,2026,12303,493
Bắc Kạn,2016,22934,105,1482,24961,2229,1667,12143,2023,12818,562
Bắc Kạn,2017,23640,85,1483,25774,2218,1748,12553,2017,13221,470
Bắc Kạn,2018,25782,82,1435,27973,2010,1676,13671,1932,14302,334
Bắc Kạn,2019,27200,80,1457,29374,2029,1605,14332,1846,15042,424
Bắc Kạn,2020,28021,79,1449,30245,2000,1589,14610,1834,15635,411
Bắc Kạn,2021,28661,74,1442,30942,1922,1523,14938,1767,16004,399
Bắc Ninh,2004,0,149,2932,88255,3851,3367,42343,0,45912,484
Bắc Ninh,2005,0,150,2822,83657,3678,3206,40643,0,43014,472
Bắc Ninh,2006,0,150,2755,82702,3660,3203,40055,0,42647,457
Bắc Ninh,2007,0,150,2684,80949,3560,3160,37898,0,43051,400
Bắc Ninh,2008,0,150,2665,79662,3587,3175,38374,0,41288,412
Bắc Ninh,2009,0,150,2697,80841,3741,3273,37801,0,43040,468
Bắc Ninh,2010,0,148,2729,82071,3783,3407,39445,0,42626,376
Bắc Ninh,2011,0,152,2728,83016,3609,3184,39517,0,43499,425
Bắc Ninh,2012,0,152,2790,85338,4064,3142,40921,0,44417,922
Bắc Ninh,2013,0,153,2870,90195,4077,3595,41955,0,48240,482
Bắc Ninh,2014,0,153,2895,93143,4109,3522,42933,0,50210,587
Bắc Ninh,2015,0,154,3063,97871,4480,4095,44826,0,53045,385
Bắc Ninh,2016,0,155,3141,100728,4693,3824,45676,0,55052,869
Bắc Ninh,2017,0,155,3203,106948,4784,4363,48232,0,58716,421
Bắc Ninh,2018,15094,153,3268,117093,4572,4305,52539,0,64554,267
Bắc Ninh,2019,525,151,3423,123948,4631,4247,55496,0,68452,384
Bắc Ninh,2020,666,151,3570,129875,4613,4234,58735,0,71140,379
Bắc Ninh,2021,994,152,3706,136093,5098,4679,62062,0,74031,419
Bến Tre,2004,0,203,3785,107953,4950,3517,51102,0,56851,1433
Bến Tre,2005,0,194,3490,101359,4898,3428,49085,0,52274,1470
Bến Tre,2006,0,191,3378,97641,4705,3217,47472,0,50169,1488
Bến Tre,2007,0,191,3353,95707,4707,3218,46467,0,49240,1489
Bến Tre,2008,0,190,3329,93453,4586,3088,45416,0,48037,1498
Bến Tre,2009,0,190,3429,98256,4605,3064,47843,0,50413,1541
Bến Tre,2010,0,189,3465,99541,4697,3102,48581,0,50960,1595
Bến Tre,2011,0,189,3449,98449,4699,3081,46285,0,52164,1618
Bến Tre,2012,0,189,3456,97969,5100,3258,47678,0,50291,1842
Bến Tre,2013,0,190,3456,97447,4969,3223,47437,0,50010,1746
Bến Tre,2014,0,190,3404,95126,5073,3296,46242,0,48884,1777
Bến Tre,2015,0,190,3356,95524,5099,3300,46447,0,49077,1799
Bến Tre,2016,0,190,3243,91507,5016,3182,44341,0,47166,1834
Bến Tre,2017,0,190,3242,92847,4889,3164,45092,0,47755,1725
Bến Tre,2018,161,188,3285,87601,4974,3112,46893,0,40708,1862
Bến Tre,2019,200,187,3270,97348,4722,3060,47229,0,50119,1662
Bến Tre,2020,235,185,3171,95695,4686,3060,46312,0,49383,1626
Bến Tre,2021,236,180,3204,99540,4481,2954,48334,0,51206,1527
Cao Bằng,2004,54218,153,3687,55812,3753,3136,25544,3640,30268,617
Cao Bằng,2005,49364,166,3547,50651,3773,3147,23695,3661,26956,626
Cao Bằng,2006,46046,172,3558,47145,3831,3192,22130,3699,25015,639
Cao Bằng,2007,44267,181,3359,45424,3545,2954,21469,3445,23955,591
Cao Bằng,2008,43178,187,3245,44117,3781,3132,21085,3329,23032,649
Cao Bằng,2009,42757,194,3075,43807,3788,3170,20932,3624,22875,618
Cao Bằng,2010,41682,208,3131,42631,3955,3160,20813,3768,21818,795
Cao Bằng,2011,42005,241,3233,43868,3922,3091,20745,3788,23123,831
Cao Bằng,2012,41769,242,3224,43608,3982,3157,20514,3809,23094,825
Cao Bằng,2013,42429,243,3156,43699,4148,3305,21271,3988,22428,843
Cao Bằng,2014,41985,245,3140,43317,4211,3350,21137,4028,22180,861
Cao Bằng,2015,42190,246,3085,43587,4220,3377,21192,4047,22395,843
Cao Bằng,2016,42669,247,3075,44189,4221,3355,21519,4043,22670,866
Cao Bằng,2017,43322,247,2960,44739,4170,3323,21791,3950,22948,847
Cao Bằng,2018,45375,190,2802,46979,4016,3244,22831,3878,24148,772
Cao Bằng,2019,47192,132,2774,48797,3964,3165,23703,3806,25094,799
Cao Bằng,2020,48618,130,2716,50317,3899,3121,24432,3739,25885,778
Cao Bằng,2021,49485,127,2690,51135,3790,3025,24900,3639,26235,765
Cà Mau,2004,2647,262,5007,124678,6922,3946,60257,0,64421,2976
Cà Mau,2005,2920,259,4698,116679,5830,3442,55427,0,61252,2388
Cà Mau,2006,2867,259,4684,113116,5817,3453,54122,0,58994,2364
Cà Mau,2007,2538,259,4684,113147,5813,3495,53647,0,59500,2318
Cà Mau,2008,2956,262,4778,113692,5881,3551,54572,0,59120,2330
Cà Mau,2009,2956,262,4789,120239,6266,3760,57715,0,62524,2506
Cà Mau,2010,3413,263,4961,123976,6033,3414,59388,0,64588,2619
Cà Mau,2011,3465,267,4958,123755,6063,3657,59204,0,64551,2406
Cà Mau,2012,3446,267,4886,121095,6419,3711,57992,0,63103,2708
Cà Mau,2013,3618,267,4859,120457,6492,3923,57914,0,62543,2569
Cà Mau,2014,3554,268,4798,117836,6596,3975,56378,0,61458,2621
Cà Mau,2015,3699,263,4780,115817,6653,4017,55354,0,60463,2636
Cà Mau,2016,3711,260,4785,110006,6453,3854,52724,0,57282,2599
Cà Mau,2017,3827,257,4356,110023,6410,3865,52720,59,57303,2545
Cà Mau,2018,4116,246,3837,95628,5907,3640,54481,59,41147,2267
Cà Mau,2019,4228,236,3868,112342,5644,3414,53957,59,58385,2230
Cà Mau,2020,4175,222,3823,109690,5560,3332,52469,61,57221,2228
Cà Mau,2021,4057,221,3832,110027,5517,3292,52789,59,57238,2225
Cần Thơ,2004,1818,170,3102,89174,4149,2663,42967,0,46207,1486
Cần Thơ,2005,1313,171,3068,87372,4188,2827,41513,0,45859,1361
Cần Thơ,2006,1581,171,3044,87126,4255,2705,39748,0,47378,1550
Cần Thơ,2007,1119,171,3017,86525,4298,2863,39742,0,46783,1435
Cần Thơ,2008,1508,176,3039,85349,4351,2946,40234,0,45115,1405
Cần Thơ,2009,1828,178,3051,89789,4351,2899,43525,0,46264,1452
Cần Thơ,2010,1953,180,3125,92168,4392,2942,44728,0,47440,1450
Cần Thơ,2011,2076,179,3323,92750,4373,2900,44736,0,48014,1473
Cần Thơ,2012,2126,181,3394,94107,4562,2930,44818,0,49289,1632
Cần Thơ,2013,2813,182,3137,96919,4496,2953,46817,0,50102,1543
Cần Thơ,2014,2826,181,3177,97793,4498,2981,47309,0,50484,1517
Cần Thơ,2015,2879,182,3176,99884,4592,3042,48439,0,51445,1550
Cần Thơ,2016,2871,181,3170,96521,4653,3001,46825,0,49696,1652
Cần Thơ,2017,2859,180,3164,96849,4574,3005,46992,69,49857,1569
Cần Thơ,2018,2956,178,3160,68601,4606,2976,48371,76,20230,1630
Cần Thơ,2019,2942,176,3143,100568,4420,2946,48586,82,51982,1474
Cần Thơ,2020,2968,173,3114,98079,4349,2930,47316,89,50763,1419
Cần Thơ,2021,2966,167,3153,99093,4280,2872,47902,84,51191,1408
Gia Lai,2004,76021,185,5845,155397,6024,4541,74566,1138,80831,1483
Gia Lai,2005,76616,192,5819,152549,6140,4675,73652,1166,78897,1465
Gia Lai,2006,77193,205,5831,150033,6186,4711,72109,1191,77924,1475
Gia Lai,2007,75421,213,5785,147738,6161,4726,71814,1181,75924,1435
Gia Lai,2008,75633,221,5874,146312,6384,4883,71304,1162,75008,1501
Gia Lai,2009,77566,235,5688,148493,6114,4780,71890,1023,76603,1334
Gia Lai,2010,32696,250,6018,150965,6742,5187,78802,1122,72163,1555
Gia Lai,2011,81825,260,6084,155564,6831,5279,76023,1180,79541,1552
Gia Lai,2012,82404,267,6097,159382,7378,5535,77482,1238,81900,1843
Gia Lai,2013,85474,271,6314,162473,7631,5894,79006,1389,83467,1737
Gia Lai,2014,84692,276,6324,163488,7818,6043,79729,1434,83759,1775
Gia Lai,2015,83352,277,6572,164676,7912,6108,80291,1472,84385,1804
Gia Lai,2016,81987,277,6712,161706,7737,5381,78886,1440,82820,2356
Gia Lai,2017,81134,278,6131,161950,7691,6027,79219,1440,82731,1664
Gia Lai,2018,82309,250,5831,166252,7166,5821,81480,1380,84772,1345
Gia Lai,2019,84006,222,5816,167624,7091,5615,81891,1320,85733,1476
Gia Lai,2020,85568,210,5752,168519,6942,5495,82307,1295,86212,1447
Gia Lai,2021,85965,209,5735,172324,6783,5405,84056,1271,88268,1378
Hà Giang,2004,82970,145,5502,91406,6154,4230,41079,3185,50327,1924
Hà Giang,2005,79243,138,5164,87127,5860,4080,41075,3246,46052,1780
Hà Giang,2006,71524,146,5041,81530,5678,3834,37589,2850,43941,1844
Hà Giang,2007,69108,150,4840,76742,5966,4160,35795,3172,40947,1806
Hà Giang,2008,68404,156,4793,75230,6103,4206,35306,3167,39924,1897
Hà Giang,2009,66250,173,4809,75090,6161,4480,35314,2952,39776,1681
Hà Giang,2010,67328,178,4899,75725,6473,5003,35850,3198,39875,1470
Hà Giang,2011,63003,184,4836,77258,6265,4357,39483,3498,37775,1908
Hà Giang,2012,70449,189,4807,79302,6643,4874,37971,3797,41331,1769
Hà Giang,2013,72496,193,4838,81600,6617,4235,42797,3721,38803,2382
Hà Giang,2014,71900,193,4857,83790,6540,4368,37884,3630,45906,2172
Hà Giang,2015,78764,197,4745,87306,6482,4422,41889,3723,45417,2060
Hà Giang,2016,81689,196,4709,90676,6459,4329,43612,3745,47064,2130
Hà Giang,2017,83647,196,4713,93385,6406,4316,44873,3729,48512,2090
Hà Giang,2018,86877,185,4590,97074,6293,4205,46561,3608,50513,2088
Hà Giang,2019,89704,174,4498,100111,6048,4094,47882,3488,52229,1954
Hà Giang,2020,91858,173,4425,102420,5861,3945,48929,3397,53491,1916
Hà Giang,2021,93793,173,4389,104641,5651,3777,49960,3278,54681,1874
Hà Nam,2004,0,139,2181,65818,2788,2604,32071,0,33747,184
Hà Nam,2005,0,139,2122,61843,2703,2525,30225,0,31618,178
Hà Nam,2006,0,139,2047,59614,2682,2502,28918,0,30696,180
Hà Nam,2007,0,139,2014,57918,2549,2349,27772,0,30146,200
Hà Nam,2008,0,140,1999,56723,2539,2353,26854,0,29869,186
Hà Nam,2009,0,140,2017,57001,2715,2493,27572,0,29429,222
Hà Nam,2010,0,140,2031,57056,2858,2617,27707,0,29349,241
Hà Nam,2011,0,140,2042,57113,2756,2530,27863,0,29250,226
Hà Nam,2012,0,140,2059,57455,2854,2496,27983,0,29472,358
Hà Nam,2013,0,140,2096,59402,2987,2748,28873,0,30529,239
Hà Nam,2014,0,121,2088,60179,3073,2824,29100,0,31079,249
Hà Nam,2015,0,121,2138,62317,3044,2801,30074,0,32243,243
Hà Nam,2016,0,121,2149,63609,3068,2559,30400,0,33209,509
Hà Nam,2017,0,121,2178,66108,2559,2364,31587,0,34521,195
Hà Nam,2018,134,121,2278,71717,3095,2594,34277,0,37440,501
Hà Nam,2019,183,121,2315,74714,3087,2823,35745,0,38969,264
Hà Nam,2020,210,116,2380,77901,3158,2893,37068,0,40833,265
Hà Nam,2021,257,116,2400,81593,3179,2908,38829,0,42764,271
Hà Nội,2004,0,269,5858,207224,8819,7804,94121,0,113103,1015
Hà Nội,2005,0,273,5804,203259,8855,8095,98112,0,105147,760
Hà Nội,2006,212,277,5738,201992,8669,7982,97417,122,104575,687
Hà Nội,2007,298,280,5706,201359,8580,7976,96077,104,105282,604
Hà Nội,2008,4284,674,13253,411202,20246,18376,198751,188,212451,1870
Hà Nội,2009,4260,677,13424,440843,20545,18637,212150,120,228693,1908
Hà Nội,2010,4965,681,13889,469622,21189,19319,226472,152,243150,1870
Hà Nội,2011,4517,687,13928,492604,20879,18954,229656,162,262948,1925
Hà Nội,2012,5772,692,14390,520355,22090,19854,248541,173,271814,2236
Hà Nội,2013,6049,696,14931,564383,22806,14226,266079,135,298304,8580
Hà Nội,2014,5802,707,15459,587471,23639,21560,274850,215,312621,2079
Hà Nội,2015,6489,717,19205,618745,24171,22153,291552,226,327193,2018
Hà Nội,2016,6995,720,16418,641554,24899,22728,301005,236,340549,2171
Hà Nội,2017,7812,727,17116,678739,25538,23228,318119,237,360620,2310
Hà Nội,2018,9633,740,18238,738864,24411,23303,344820,266,394044,1108
Hà Nội,2019,10942,754,19048,765571,25512,23378,356907,294,408664,2134
Hà Nội,2020,12179,756,19958,791547,27818,25576,369146,348,422401,2242
Hà Nội,2021,13771,762,20776,822553,28444,26147,384475,392,438078,2297
Hà Tĩnh,2004,0,313,4769,137157,6108,5503,66217,0,70940,605
Hà Tĩnh,2005,0,310,4494,124643,5497,4902,60121,0,64522,595
Hà Tĩnh,2006,0,309,4271,114246,5435,4889,55133,0,59113,546
Hà Tĩnh,2007,0,309,4122,109269,5359,4622,52273,0,56996,737
Hà Tĩnh,2008,0,309,3984,102097,5491,4870,49329,0,52768,621
Hà Tĩnh,2009,0,307,4177,99265,5614,4823,50227,0,49038,791
Hà Tĩnh,2010,0,306,3942,98395,5658,5010,47861,0,50534,648
Hà Tĩnh,2011,0,304,3928,99521,5400,4867,48410,0,51111,533
Hà Tĩnh,2012,0,280,3887,95994,5802,5180,46662,0,49332,622
Hà Tĩnh,2013,0,261,4053,97307,5532,4930,46551,0,50756,602
Hà Tĩnh,2014,0,261,4095,97284,5429,4805,46943,0,50341,624
Hà Tĩnh,2015,0,260,3789,100458,5421,4755,48674,0,51784,666
Hà Tĩnh,2016,0,259,3673,99318,5424,4739,47976,0,51342,685
Hà Tĩnh,2017,0,259,3739,103223,5340,4738,49837,0,53386,602
Hà Tĩnh,2018,413,250,3865,112090,5399,4692,53753,0,58337,707
Hà Tĩnh,2019,456,241,3943,118608,5259,4645,56821,0,61787,614
Hà Tĩnh,2020,524,221,4028,121245,5411,4784,57772,0,63473,627
Hà Tĩnh,2021,564,221,4230,131983,5494,4856,63296,0,68687,638
Hòa Bình,2004,55305,210,3529,70718,5448,4653,33947,2271,36771,795
Hòa Bình,2005,50275,215,3434,64740,5252,4500,31024,2064,33716,752
Hòa Bình,2006,46691,219,3244,61139,4987,4250,29588,1963,31551,737
Hòa Bình,2007,45349,221,3368,59382,4923,4195,28738,1937,30644,728
Hòa Bình,2008,43484,216,3086,56988,4829,4114,27538,1900,29450,715
Hòa Bình,2009,42085,216,3594,55683,4681,4006,27098,1929,28585,675
Hòa Bình,2010,44406,219,3170,58911,5244,4369,29047,2157,29864,875
Hòa Bình,2011,45118,221,3132,59973,4758,4219,29030,2060,30943,539
Hòa Bình,2012,44767,220,3099,61094,4780,3851,30335,1962,30759,929
Hòa Bình,2013,48182,216,3487,64107,4986,4192,30778,2218,33329,794
Hòa Bình,2014,50040,214,4163,66303,5032,4197,31927,2205,34376,835
Hòa Bình,2015,52254,209,3581,69118,4956,4137,33252,2202,35866,819
Hòa Bình,2016,54200,159,3127,71303,4839,4037,34251,2153,37052,802
Hòa Bình,2017,57459,132,3734,74942,4895,4022,35935,2222,39007,873
Hòa Bình,2018,61641,84,3235,79927,4728,3920,38098,2188,41829,808
Hòa Bình,2019,63144,35,3176,81255,4632,3817,38866,2155,42389,815
Hòa Bình,2020,66659,29,3300,85244,4708,3852,40579,2264,44665,856
Hòa Bình,2021,67414,28,3277,86413,4527,3681,40994,2211,45419,846
Hưng Yên,2004,0,169,3081,89157,4123,3816,44165,0,44992,307
Hưng Yên,2005,0,169,2914,84637,3890,3556,41588,0,43049,334
Hưng Yên,2006,0,169,2901,82482,3727,3328,39337,0,43145,399
Hưng Yên,2007,0,169,2764,80664,3850,3474,38139,0,42525,376
Hưng Yên,2008,0,169,2730,77602,3648,3416,36691,0,40911,232
Hưng Yên,2009,0,169,2712,76924,3668,3259,37425,0,39499,409
Hưng Yên,2010,0,169,2719,77757,3742,3236,36698,0,41059,506
Hưng Yên,2011,0,169,2721,78361,3965,3388,37673,0,40688,577
Hưng Yên,2012,0,169,2767,80503,4066,3724,37929,0,42574,342
Hưng Yên,2013,0,169,2901,85985,4181,3835,40064,0,45921,346
Hưng Yên,2014,0,169,2927,89151,4353,3979,41127,0,48024,374
Hưng Yên,2015,0,170,3053,94706,4421,4060,43230,0,51476,361
Hưng Yên,2016,0,170,3079,98298,4492,3716,44812,0,53486,776
Hưng Yên,2017,0,170,3154,102801,4436,4071,46763,0,56038,365
Hưng Yên,2018,185,161,3311,112497,4225,4031,51311,0,61186,194
Hưng Yên,2019,230,152,3383,116912,4330,3991,53631,0,63281,339
Hưng Yên,2020,340,141,3423,121073,4299,3967,55700,0,65373,332
Hưng Yên,2021,432,141,3454,126241,4305,3955,58174,0,68067,350
Hải Dương,2004,0,279,4347,128695,5778,5299,62358,0,66337,479
Hải Dương,2005,0,279,4193,122809,5367,4916,59555,0,63254,451
Hải Dương,2006,450,279,4113,120479,5443,4929,58501,0,61978,514
Hải Dương,2007,477,279,4135,119154,5746,5146,57822,0,61332,600
Hải Dương,2008,659,279,4135,116639,6006,5399,58140,0,58499,607
Hải Dương,2009,469,279,4205,117058,6184,5575,56573,0,60485,609
Hải Dương,2010,471,279,4322,117645,6562,5916,56486,0,61159,646
Hải Dương,2011,809,279,4382,117105,6840,6149,56578,0,60527,691
Hải Dương,2012,449,279,4323,120447,6950,6237,58996,0,61451,713
Hải Dương,2013,472,279,4554,126259,7182,6480,59653,0,66606,702
Hải Dương,2014,485,281,4939,129867,7304,6593,60731,0,69136,711
Hải Dương,2015,472,282,4782,139346,7510,6746,64586,0,74760,764
Hải Dương,2016,459,283,4936,146165,7546,5150,67589,0,78576,2396
Hải Dương,2017,465,284,5155,154747,7714,6990,71458,0,83289,724
Hải Dương,2018,544,267,5308,167636,6978,6686,77389,0,90247,292
Hải Dương,2019,594,250,5294,171984,7002,6381,79537,0,92447,621
Hải Dương,2020,705,245,5559,180419,7415,6732,83406,0,97013,683
Hải Dương,2021,856,244,5664,187176,7297,6625,86663,0,100513,672
Hải Phòng,2004,0,217,4242,128844,6117,5725,62562,0,66282,392
Hải Phòng,2005,0,218,3994,120778,5897,5409,58518,0,62260,488
Hải Phòng,2006,0,216,3875,117101,5994,5549,56158,0,60943,445
Hải Phòng,2007,0,218,3786,114308,6114,5655,54164,0,60144,459
Hải Phòng,2008,0,218,3769,112599,5985,5549,53495,0,59104,436
Hải Phòng,2009,0,218,3817,116620,6335,5848,56632,0,59988,487
Hải Phòng,2010,0,219,3938,120906,6196,5786,57848,0,63058,410
Hải Phòng,2011,0,218,4164,121772,6269,5866,58516,0,63256,403
Hải Phòng,2012,0,218,4060,128740,6377,5976,61164,0,67576,401
Hải Phòng,2013,0,232,4356,138730,6416,5966,66749,0,71981,450
Hải Phòng,2014,0,231,4440,145216,6427,6002,69618,0,75598,425
Hải Phòng,2015,0,216,4461,154898,6497,6054,74129,0,80769,443
Hải Phòng,2016,0,216,4670,163184,6544,6099,77892,0,85292,445
Hải Phòng,2017,0,218,5347,172244,6511,6075,82127,0,90117,436
Hải Phòng,2018,127,219,5039,187422,6526,6042,89292,0,98130,484
Hải Phòng,2019,156,220,5192,192337,6372,6009,92171,0,100166,363
Hải Phòng,2020,275,219,5314,196501,6943,6570,93641,0,102860,373
Hải Phòng,2021,414,219,5396,200212,6898,6531,95182,0,105030,367
Hậu Giang,2004,2446,160,2744,68526,3671,1858,32542,0,35984,1813
Hậu Giang,2005,2266,164,2629,64957,3591,1823,30805,0,34152,1768
Hậu Giang,2006,2289,166,2621,64413,3704,1916,30843,0,33570,1788
Hậu Giang,2007,2238,171,2613,62955,3626,1919,30187,0,32768,1707
Hậu Giang,2008,2225,171,2497,62066,3595,1854,29781,0,32285,1741
Hậu Giang,2009,2068,169,2587,65138,3528,1778,30696,0,34442,1750
Hậu Giang,2010,2193,168,2615,67181,3586,1869,32163,0,35018,1717
Hậu Giang,2011,2237,170,2621,67497,3318,1732,32268,0,35229,1586
Hậu Giang,2012,2262,170,2615,68800,3717,1585,29334,0,39466,2132
Hậu Giang,2013,2480,171,2624,70231,3578,1847,33713,0,36518,1731
Hậu Giang,2014,2450,169,2572,69033,3587,1849,32956,0,36077,1738
Hậu Giang,2015,2471,168,2602,69375,3664,1882,33461,0,35914,1782
Hậu Giang,2016,2352,169,2588,67049,3730,1893,32346,0,34703,1837
Hậu Giang,2017,2371,170,2588,66683,3688,1911,32057,0,34626,1777
Hậu Giang,2018,2682,166,2506,121257,3577,1788,33126,0,88131,1789
Hậu Giang,2019,2689,162,2455,68754,3316,1665,33223,0,35531,1651
Hậu Giang,2020,2778,153,2406,67192,3214,1613,32691,0,34501,1601
Hậu Giang,2021,2684,150,2405,66425,3139,1569,32323,0,34102,1570
Khánh Hòa,2004,10567,174,3763,113657,4483,3723,54330,119,59327,760
Khánh Hòa,2005,9313,177,3644,107250,4361,3641,52001,119,55249,720
Khánh Hòa,2006,8534,180,3547,103029,4361,3634,49846,119,53183,727
Khánh Hòa,2007,8028,181,3468,99862,4459,3724,47860,127,52002,735
Khánh Hòa,2008,7738,186,3397,97535,4138,2979,46432,116,51103,1159
Khánh Hòa,2009,8059,186,3442,101272,4035,3621,49023,119,52249,414
Khánh Hòa,2010,8168,189,3487,102048,4733,3885,49598,135,52450,848
Khánh Hòa,2011,7683,188,3496,101184,4807,3943,46023,128,55161,864
Khánh Hòa,2012,7760,187,3500,101146,5096,4146,49028,122,52118,950
Khánh Hòa,2013,7886,185,3521,101594,5051,4144,49038,159,52556,907
Khánh Hòa,2014,7925,186,3506,100656,5075,4196,48637,156,52019,879
Khánh Hòa,2015,7893,186,3521,101552,5051,4225,49148,159,52404,826
Khánh Hòa,2016,7986,186,3460,97368,4992,4079,47190,161,50178,913
Khánh Hòa,2017,8070,186,3390,98721,4987,4179,47873,169,50848,808
Khánh Hòa,2018,8274,184,3391,103512,4952,4077,50280,170,53232,875
Khánh Hòa,2019,8493,183,3338,105380,4746,3975,51165,172,54215,771
Khánh Hòa,2020,8785,179,3309,105492,4558,3817,51126,158,54366,741
Khánh Hòa,2021,8959,174,3390,111507,4721,3982,54115,163,57392,739
Kiên Giang,2004,24888,254,6708,176977,7812,4486,82964,452,94013,3326
Kiên Giang,2005,24493,261,6497,166676,7662,4454,79633,461,87043,3208
Kiên Giang,2006,22592,266,6522,161834,7517,4358,76327,429,85507,3159
Kiên Giang,2007,21830,279,6476,159389,7488,4385,76946,425,82443,3103
Kiên Giang,2008,21992,283,6576,157258,7677,4411,74623,499,82635,3266
Kiên Giang,2009,21492,295,6239,161167,8010,4598,77529,520,83638,3412
Kiên Giang,2010,21736,298,6695,163536,8330,4869,78937,560,84599,3461
Kiên Giang,2011,20890,304,6577,160875,8439,4901,76995,574,83880,3538
Kiên Giang,2012,21309,301,6556,159981,8799,4622,76836,589,83145,4177
Kiên Giang,2013,21545,300,6601,160748,9115,5230,77065,680,83683,3885
Kiên Giang,2014,21707,296,6523,160579,8942,5260,77377,692,83202,3682
Kiên Giang,2015,21760,296,6453,161650,9018,5329,77870,708,83780,3689
Kiên Giang,2016,21970,296,6374,158037,8993,5213,75972,711,82065,3780
Kiên Giang,2017,22031,294,6302,157724,8956,5297,75987,706,81737,3659
Kiên Giang,2018,23224,286,6105,100215,9019,5174,79424,722,20791,3845
Kiên Giang,2019,24668,279,5852,165349,8617,5051,80178,737,85171,3566
Kiên Giang,2020,24805,267,5518,162411,8438,4911,78556,748,83855,3527
Kiên Giang,2021,23936,262,5486,159055,8145,4798,77278,713,81777,3347
Kon Tum,2004,0,105,2190,55574,2901,2244,26694,568,28880,657
Kon Tum,2005,0,99,2163,54263,2963,2323,26238,585,28025,640
Kon Tum,2006,33019,113,2315,52823,2924,2213,23497,595,29326,711
Kon Tum,2007,33422,115,2822,50879,2965,2340,24619,640,26260,625
Kon Tum,2008,32624,123,2737,50107,2609,2117,24369,642,25738,492
Kon Tum,2009,32409,126,3062,50680,2992,2379,24679,594,26001,613
Kon Tum,2010,32696,131,2482,51609,3209,2572,25073,590,26536,637
Kon Tum,2011,31370,131,2484,52130,3171,2492,24977,568,27153,679
Kon Tum,2012,34777,140,2524,53451,3382,2477,32274,546,21177,905
Kon Tum,2013,34557,141,2456,55079,3472,2810,27323,682,27756,662
Kon Tum,2014,35270,143,2587,56425,3529,2842,27463,722,28962,687
Kon Tum,2015,35721,145,2547,57707,3406,2763,28296,683,29411,643
Kon Tum,2016,35922,146,2533,57813,3509,2672,28359,704,29454,837
Kon Tum,2017,36746,147,2603,59512,3457,2814,29135,678,30377,643
Kon Tum,2018,37788,133,2525,62073,3403,2727,30431,665,31642,676
Kon Tum,2019,38397,119,2498,62916,3237,2640,30697,652,32219,597
Kon Tum,2020,39393,99,2487,64013,3360,2738,31140,725,32873,622
Kon Tum,2021,39683,94,2488,65706,3337,2724,31969,746,33737,613
Lai Châu,2004,38091,67,2464,41457,2610,1729,17962,944,23495,881
Lai Châu,2005,40309,84,2625,44412,2886,1760,18659,904,25753,1126
Lai Châu,2006,35991,100,2821,42688,3282,1968,19207,992,23481,1314
Lai Châu,2007,40140,111,2987,42908,3559,2023,19053,1023,23855,1536
Lai Châu,2008,38726,120,2967,41848,3610,2150,19293,1164,22555,1460
Lai Châu,2009,39397,130,2938,42624,3880,2386,19966,1342,22658,1494
Lai Châu,2010,40321,135,3255,43744,4039,2495,20728,1454,23016,1544
Lai Châu,2011,41832,137,3265,45551,4237,2577,21746,1527,23805,1660
Lai Châu,2012,43525,139,3132,47630,4114,2517,22865,1600,24765,1597
Lai Châu,2013,45332,148,3072,50164,4271,2647,24122,1718,26042,1624
Lai Châu,2014,46334,145,2975,51709,4219,2604,24925,1715,26784,1615
Lai Châu,2015,47075,144,2821,53159,4151,2563,25722,1697,27437,1588
Lai Châu,2016,47937,143,2728,54424,4017,2499,26444,1656,27980,1518
Lai Châu,2017,48197,140,2650,55314,3896,2414,26817,1610,28497,1482
Lai Châu,2018,49120,118,2586,57063,3808,2363,27640,1596,29423,1445
Lai Châu,2019,49769,97,2543,58117,3767,2312,28123,1581,29994,1455
Lai Châu,2020,50015,94,2542,58745,3664,2231,28366,1556,30379,1433
Lai Châu,2021,49847,90,2447,59016,3557,2155,28345,1533,30671,1402
Long An,2004,0,243,4689,122756,5357,3879,58891,0,63865,1478
Long An,2005,0,247,4446,117544,5403,3839,56433,0,61111,1564
Long An,2006,0,244,4334,114801,5105,3609,55083,0,59718,1496
Long An,2007,0,239,4167,112182,5128,3586,53859,0,58323,1542
Long An,2008,0,239,4190,109474,5240,3664,55831,0,53643,1576
Long An,2009,0,247,4318,117835,5346,3725,56390,0,61445,1621
Long An,2010,0,247,4292,122003,5616,3896,58524,0,63479,1720
Long An,2011,0,246,4373,122658,5857,4078,59054,0,63604,1779
Long An,2012,0,249,4401,125089,6486,4414,59916,0,65173,2072
Long An,2013,0,253,4464,127098,6404,4465,61392,0,65706,1939
Long An,2014,0,255,4409,127094,6491,4526,61377,0,65717,1965
Long An,2015,0,259,4421,130708,6423,4446,63162,0,67546,1977
Long An,2016,0,261,4319,128327,6355,4374,62011,0,66316,1981
Long An,2017,0,262,4290,130478,6357,4429,63117,0,67361,1928
Long An,2018,785,226,4315,138126,6258,4297,66153,0,71973,1961
Long An,2019,976,190,4342,138772,6028,4165,67017,0,71755,1863
Long An,2020,1126,185,4327,136232,6028,4159,65887,0,70345,1869
Long An,2021,1164,184,4344,138215,5880,4052,67022,0,71193,1828
Lào Cai,2004,54493,199,3988,71565,4166,3197,34118,997,37447,969
Lào Cai,2005,50685,218,3874,66536,4086,3082,31861,986,34675,1004
Lào Cai,2006,49649,226,3861,64426,4150,3144,30854,956,33572,1006
Lào Cai,2007,47852,229,3753,62465,4236,3205,30103,992,32362,1031
Lào Cai,2008,45188,234,3770,60735,3906,3034,28997,1104,31738,872
Lào Cai,2009,44215,236,3897,61298,4760,3515,28631,1117,32667,1245
Lào Cai,2010,45026,237,3871,62551,4915,3415,31901,1039,30650,1500
Lào Cai,2011,46812,240,3908,64674,5183,3668,30989,1388,33685,1515
Lào Cai,2012,49694,239,3932,66447,5480,3845,31318,1737,35129,1635
Lào Cai,2013,50899,241,3989,69102,5323,3706,33131,1744,35971,1617
Lào Cai,2014,51418,238,4270,69964,5498,3925,33544,1917,36420,1573
Lào Cai,2015,53475,231,3935,73271,5758,4128,35233,1983,38038,1630
Lào Cai,2016,54502,223,3889,75072,5605,4016,35957,1910,39115,1589
Lào Cai,2017,55063,212,3808,76537,5644,4070,36656,1969,39881,1574
Lào Cai,2018,56724,199,3714,79481,5524,3936,38005,1931,41476,1588
Lào Cai,2019,58458,186,3597,81991,5251,3802,39070,1893,42921,1449
Lào Cai,2020,59549,182,3539,83549,5116,3699,39614,1910,43935,1417
Lào Cai,2021,60395,182,3500,85348,5058,3666,40451,1876,44897,1392
Lâm Đồng,2004,39466,245,4335,131814,5269,4566,63426,310,68388,703
Lâm Đồng,2005,38273,247,4309,127392,5156,4489,61616,457,65776,667
Lâm Đồng,2006,35972,247,4237,123630,5130,4466,59754,441,63876,664
Lâm Đồng,2007,35319,248,4243,120994,5027,4164,58564,358,62430,863
Lâm Đồng,2008,34362,247,4129,117816,5113,4244,56843,308,60973,869
Lâm Đồng,2009,33107,249,4161,116478,5106,4361,56337,456,60141,745
Lâm Đồng,2010,32892,251,4113,114688,5457,4587,51000,434,63688,870
Lâm Đồng,2011,31195,251,4088,112291,5083,4479,56580,472,55711,604
Lâm Đồng,2012,30866,255,4098,111655,5968,4740,52643,510,59012,1228
Lâm Đồng,2013,30809,254,4586,114423,5596,4872,54941,464,59482,724
Lâm Đồng,2014,31041,254,4179,116722,6104,5254,56206,590,60516,850
Lâm Đồng,2015,31483,253,4234,120253,6204,5335,58054,618,62199,869
Lâm Đồng,2016,32087,254,4224,119685,6326,4168,57561,644,62124,2158
Lâm Đồng,2017,32989,256,4201,122082,6319,5422,58988,656,63094,897
Lâm Đồng,2018,35550,252,4195,127011,6283,5280,61612,657,65399,1003
Lâm Đồng,2019,37046,249,4177,128565,5987,5138,62246,658,66319,849
Lâm Đồng,2020,37985,244,4142,128748,5889,5046,62145,638,66603,843
Lâm Đồng,2021,39314,225,4151,134930,5728,4905,65076,610,69854,823
Lạng Sơn,2004,69227,173,3989,79182,4763,4077,38034,3955,41148,686
Lạng Sơn,2005,61728,177,3800,70738,5836,4753,34151,4689,36587,1083
Lạng Sơn,2006,56026,219,3676,64381,4630,3933,30967,3832,33414,697
Lạng Sơn,2007,50470,220,3669,60552,4716,3997,29250,3909,31302,719
Lạng Sơn,2008,49811,233,3607,57431,4813,4014,27827,3949,29604,799
Lạng Sơn,2009,49057,242,3557,57275,4921,4088,27573,4107,29702,833
Lạng Sơn,2010,49240,245,3639,57583,5027,4144,27774,4193,29809,883
Lạng Sơn,2011,48645,248,3625,56989,4798,3951,27440,4270,29549,847
Lạng Sơn,2012,48388,247,3740,56844,5183,4264,27296,4346,29548,919
Lạng Sơn,2013,48818,247,3565,57607,5182,4243,27894,4457,29713,939
Lạng Sơn,2014,48383,248,3471,57295,5011,4096,27677,4214,29618,915
Lạng Sơn,2015,49445,248,3433,58639,4997,4067,28207,4216,30432,930
Lạng Sơn,2016,51763,247,3387,60952,5029,4036,29176,4268,31776,993
Lạng Sơn,2017,54087,237,3414,63352,4963,4042,30327,4212,33025,921
Lạng Sơn,2018,58483,217,3283,68004,4829,3883,32356,4026,35648,946
Lạng Sơn,2019,62105,197,3263,71597,4572,3724,33911,3840,37686,848
Lạng Sơn,2020,64371,182,3283,73883,4667,3802,34835,3935,39048,865
Lạng Sơn,2021,65093,180,3311,75116,4565,3712,35279,3799,39837,853
Nam Định,2004,0,293,5008,160817,6344,5771,80142,0,80675,573
Nam Định,2005,0,293,4751,151382,6188,5574,74451,0,76931,614
Nam Định,2006,0,292,4662,146425,6248,5524,73944,0,72481,724
Nam Định,2007,0,292,4562,140738,5870,5136,68092,0,72646,734
Nam Định,2008,0,292,4435,137771,5840,5154,66467,0,71304,686
Nam Định,2009,0,291,4409,137242,6053,5268,65755,0,71487,785
Nam Định,2010,0,291,4395,136234,6362,5550,65405,0,70829,812
Nam Định,2011,0,290,4593,132395,6260,5519,63584,0,68811,741
Nam Định,2012,0,291,4484,134651,6502,5749,64600,0,70051,753
Nam Định,2013,0,292,4452,137745,6617,5847,65976,0,71769,770
Nam Định,2014,0,293,4544,139606,6756,5974,66923,0,72683,782
Nam Định,2015,0,293,4595,143563,6633,5871,68951,0,74612,762
Nam Định,2016,0,292,4668,146535,6824,5941,70213,0,76322,883
Nam Định,2017,0,292,4761,149227,6975,6147,71137,0,78090,828
Nam Định,2018,254,260,4854,158207,6907,6028,75527,0,82680,879
Nam Định,2019,276,228,4792,159933,6711,5910,76279,0,83654,801
Nam Định,2020,360,226,4804,164935,6524,5682,78536,0,86399,842
Nam Định,2021,420,226,4836,170608,6490,5680,81095,0,89513,810
Nghệ An,2004,52762,631,11772,311499,16033,13282,143025,1282,168474,2751
Nghệ An,2005,55985,615,11065,281078,15019,13254,141191,1304,139887,1765
Nghệ An,2006,50782,575,10309,254662,14826,13291,126524,1237,128138,1535
Nghệ An,2007,43172,565,9936,241073,14415,13214,121054,1459,120019,1201
Nghệ An,2008,40432,570,9887,229997,14034,12864,112746,1423,117251,1170
Nghệ An,2009,39480,551,9738,225960,13508,11142,110279,1452,115681,2366
Nghệ An,2010,40834,542,9825,230004,14020,11866,110281,1446,119723,2154
Nghệ An,2011,41409,538,9816,232037,13974,11754,110297,1632,121740,2220
Nghệ An,2012,42347,538,9730,231192,14332,13079,111498,1817,119694,1253
Nghệ An,2013,42983,541,9718,237571,14085,11774,113604,1813,123967,2311
Nghệ An,2014,43138,543,9915,240771,13821,11915,115444,1813,125327,1906
Nghệ An,2015,43539,544,9733,248832,13716,11751,119681,1821,129151,1965
Nghệ An,2016,43867,542,9493,248925,13424,10641,119033,1703,129892,2783
Nghệ An,2017,44695,541,9618,261708,13275,11367,125091,1666,136617,1908
Nghệ An,2018,46721,532,9896,285380,13004,11047,136142,1656,149238,1957
Nghệ An,2019,48980,522,10123,303948,12535,10727,144851,1645,159097,1808
Nghệ An,2020,49871,504,10224,313346,12649,10814,148696,1643,164650,1835
Nghệ An,2021,51606,496,10612,338783,12748,10928,161527,1722,177256,1820
Ninh Bình,2004,2300,154,2646,72726,3598,3388,35192,0,37534,210
Ninh Bình,2005,2363,154,2479,66908,3419,3195,32450,0,34458,224
Ninh Bình,2006,1944,154,2369,63884,3103,2922,31870,73,32014,181
Ninh Bình,2007,2040,154,2279,61796,3208,2962,29517,67,32279,246
Ninh Bình,2008,1974,153,2256,61058,3076,2824,29151,46,31907,252
Ninh Bình,2009,1968,153,2282,62310,3224,2939,30072,47,32238,285
Ninh Bình,2010,2042,152,2297,63087,3252,2992,30268,45,32819,260
Ninh Bình,2011,2127,151,2330,63275,3250,2947,28969,54,34306,303
Ninh Bình,2012,2201,150,2321,64976,3415,2922,31622,63,33354,493
Ninh Bình,2013,2388,150,2369,67457,3418,2981,33002,62,34455,437
Ninh Bình,2014,2569,150,2355,67309,3526,3179,32735,71,34574,347
Ninh Bình,2015,2776,150,2405,70461,3568,3217,34195,62,36266,351
Ninh Bình,2016,2965,150,2417,71279,3551,3078,34462,64,36817,473
Ninh Bình,2017,3094,152,2455,73908,3630,3247,35650,75,38258,383
Ninh Bình,2018,3425,152,2532,82587,3655,3244,39580,84,43007,411
Ninh Bình,2019,3589,153,2634,85475,3639,3241,40980,94,44495,398
Ninh Bình,2020,3828,150,2709,89888,3692,3270,43113,97,46775,422
Ninh Bình,2021,4096,146,2770,95961,3661,3241,45981,96,49980,420
Ninh Thuận,2004,17718,136,2432,67610,2703,2269,32847,491,34763,434
Ninh Thuận,2005,17038,137,2365,64146,2716,2274,31120,509,33026,442
Ninh Thuận,2006,16569,138,2312,61002,2661,2240,29615,488,31387,421
Ninh Thuận,2007,16750,140,2287,58789,2726,2281,28461,538,30328,445
Ninh Thuận,2008,16309,141,2279,57103,2739,2297,27665,571,29438,442
Ninh Thuận,2009,16235,146,2200,57355,2818,2341,28142,541,29213,477
Ninh Thuận,2010,16044,146,2269,57579,2845,2308,25900,460,31679,537
Ninh Thuận,2011,16281,147,2254,57166,2720,2268,27748,548,29418,452
Ninh Thuận,2012,15884,149,2292,56905,2834,2223,27711,637,29194,611
Ninh Thuận,2013,15814,152,2382,56852,3016,2442,27699,674,29153,574
Ninh Thuận,2014,15907,152,2224,56470,3052,2474,27302,702,29168,578
Ninh Thuận,2015,16085,152,2172,56556,3076,2490,27491,745,29065,586
Ninh Thuận,2016,15940,153,2145,55041,3136,2439,26619,759,28422,697
Ninh Thuận,2017,16140,152,2133,55611,3139,2551,26994,755,28617,588
Ninh Thuận,2018,16824,147,2131,57997,3094,2451,28217,720,29780,643
Ninh Thuận,2019,17185,142,2148,59278,2903,2351,28909,684,30369,552
Ninh Thuận,2020,17270,135,2142,59950,3036,2464,29233,730,30717,572
Ninh Thuận,2021,18056,133,2208,62757,2830,2339,30497,676,32260,491
Phú Thọ,2004,19427,293,4856,108357,6574,5762,51706,739,56651,812
Phú Thọ,2005,17274,293,4442,98138,6283,5341,47827,701,50311,942
Phú Thọ,2006,16040,295,4262,92458,5899,5198,45139,692,47319,701
Phú Thọ,2007,15953,296,4255,91024,6021,5254,44202,737,46822,767
Phú Thọ,2008,15880,300,4225,90012,6024,5260,44099,744,45913,764
Phú Thọ,2009,16302,300,4240,92205,6132,5356,45294,754,46911,776
Phú Thọ,2010,17285,300,4356,95298,6165,5363,46205,875,49093,802
Phú Thọ,2011,17959,300,4360,96984,5916,5173,46703,894,50281,743
Phú Thọ,2012,18307,300,4351,98933,6073,5075,47046,912,51887,998
Phú Thọ,2013,19758,300,4421,104992,6155,5347,50027,916,54965,808
Phú Thọ,2014,20706,299,4394,108305,6264,5404,51726,939,56579,860
Phú Thọ,2015,22041,299,4490,114463,6427,5495,54605,1003,59858,932
Phú Thọ,2016,23718,299,4470,120492,6465,5178,57312,1010,63180,1287
Phú Thọ,2017,25368,299,4493,126328,6400,5435,60147,1048,66181,965
Phú Thọ,2018,28058,294,4598,137394,6046,5313,65230,1060,72164,733
Phú Thọ,2019,29368,288,4583,140400,6110,5191,66415,1072,73985,919
Phú Thọ,2020,30667,285,4691,145878,6303,5342,68894,1101,76984,961
Phú Thọ,2021,31303,276,4747,149691,6225,5257,70467,1091,79224,968
Phú Yên,2004,5647,154,3880,85495,4630,3485,41068,0,44427,1145
Phú Yên,2005,7087,157,3227,83471,4768,3260,40232,0,43239,1508
Phú Yên,2006,6732,157,3262,81772,4592,3122,39646,105,42126,1470
Phú Yên,2007,6004,159,3228,80872,4623,3120,39168,105,41704,1503
Phú Yên,2008,6208,162,3302,78639,4555,3064,38094,129,40545,1491
Phú Yên,2009,5134,165,3203,79536,4489,2824,38389,129,41147,1665
Phú Yên,2010,6367,163,3275,79191,4540,3002,38527,119,40664,1538
Phú Yên,2011,7466,170,3443,80161,4690,3161,38642,125,41519,1529
Phú Yên,2012,6418,169,3229,76678,4632,3140,37050,131,39628,1492
Phú Yên,2013,6493,169,3212,76274,4357,3139,37088,43,39186,1218
Phú Yên,2014,6586,167,3137,74513,4596,3139,36129,140,38384,1457
Phú Yên,2015,6557,168,3061,74589,4535,3112,36261,143,38328,1423
Phú Yên,2016,6527,169,2954,70884,4492,3059,34411,129,36473,1433
Phú Yên,2017,6503,169,2928,71507,4419,3032,34650,134,36857,1387
Phú Yên,2018,6644,132,2890,74690,4193,2862,36149,130,38541,1331
Phú Yên,2019,6792,94,2925,76350,3985,2693,36987,126,39363,1292
Phú Yên,2020,6949,95,2873,76535,3874,2626,37013,123,39522,1248
Phú Yên,2021,7114,96,2922,80712,3669,2491,39102,122,41610,1178
Quảng Bình,2004,2884,240,3252,92475,3895,3371,44772,0,47703,524
Quảng Bình,2005,3024,234,3085,84629,3751,3242,40823,0,43806,509
Quảng Bình,2006,2802,231,2979,76969,3660,3185,37209,0,39760,475
Quảng Bình,2007,2565,209,2930,74094,3871,3280,35038,0,39056,591
Quảng Bình,2008,3334,209,2903,70529,3804,3332,33182,0,37347,472
Quảng Bình,2009,3317,205,3132,71252,4077,3453,34603,0,36649,624
Quảng Bình,2010,3366,207,3136,71125,4238,3602,34605,0,36520,636
Quảng Bình,2011,3496,210,3110,71616,4218,3581,34817,0,36799,637
Quảng Bình,2012,3477,209,3031,70562,4272,3553,34291,0,36271,719
Quảng Bình,2013,3233,210,3030,71194,4535,3769,34522,0,36672,766
Quảng Bình,2014,3212,208,3026,70722,4526,3784,34199,0,36523,742
Quảng Bình,2015,3250,211,3040,72732,4683,3901,35251,0,37481,782
Quảng Bình,2016,3227,210,2985,71074,4639,3297,34386,0,36688,1342
Quảng Bình,2017,3216,209,3129,73754,4621,3931,35674,0,38080,690
Quảng Bình,2018,3421,201,3041,78986,4373,3834,38135,0,40851,539
Quảng Bình,2019,3570,193,3102,82282,4359,3737,39568,0,42714,622
Quảng Bình,2020,3635,189,3174,84559,4417,3806,40603,0,43956,611
Quảng Bình,2021,3936,188,3349,92088,4519,3903,44308,0,47780,616
Quảng Nam,2004,19334,256,5551,147030,6513,5097,75155,162,71875,1416
Quảng Nam,2005,17444,263,5441,137444,6517,5071,66430,170,71014,1446
Quảng Nam,2006,17444,266,5069,128428,6337,4951,65799,74,62629,1386
Quảng Nam,2007,15406,268,4920,120916,6275,4887,59229,158,61687,1388
Quảng Nam,2008,10952,266,4949,112119,6116,4841,53978,146,58141,1275
Quảng Nam,2009,11323,270,4720,114701,6366,4826,53298,168,61403,1540
Quảng Nam,2010,14526,269,4860,113438,6469,5057,55027,193,58411,1412
Quảng Nam,2011,14634,269,4790,111823,6433,5074,54151,199,57672,1359
Quảng Nam,2012,14629,272,4694,111331,6858,5380,53629,205,57702,1478
Quảng Nam,2013,14974,271,4713,112387,6953,5467,54271,287,58116,1486
Quảng Nam,2014,15789,275,4765,114110,7149,5616,55063,361,59047,1533
Quảng Nam,2015,16067,274,4859,117223,7312,5750,56527,395,60696,1562
Quảng Nam,2016,16205,275,4676,113946,7271,4816,54687,424,59259,2455
Quảng Nam,2017,16585,274,4703,118451,7183,5756,56901,462,61550,1427
Quảng Nam,2018,17003,260,4715,125461,6863,5350,60183,447,65278,1513
Quảng Nam,2019,17247,246,4554,127524,6167,4944,61190,432,66334,1223
Quảng Nam,2020,17767,241,4673,132053,5885,4709,63265,441,68788,1176
Quảng Nam,2021,18278,234,4866,142046,6153,4976,68519,539,73527,1177
Quảng Ngãi,2004,21181,229,4502,129885,5281,4032,62989,260,66896,1249
Quảng Ngãi,2005,20166,235,4251,118484,5089,3940,56489,228,61995,1149
Quảng Ngãi,2006,18616,232,4030,108440,5003,3819,53829,225,54611,1184
Quảng Ngãi,2007,17586,234,3898,101811,4918,3755,49433,230,52378,1163
Quảng Ngãi,2008,17142,230,3841,97129,4863,3756,47026,200,50103,1107
Quảng Ngãi,2009,16560,228,3807,96688,4919,3758,46916,215,49772,1161
Quảng Ngãi,2010,17364,224,3879,96191,4831,3688,46412,230,49779,1143
Quảng Ngãi,2011,16224,222,3864,96052,4850,3791,43773,237,52279,1059
Quảng Ngãi,2012,19165,218,3875,96803,5085,3868,45633,244,51170,1217
Quảng Ngãi,2013,18690,217,3882,97627,5133,3937,46943,251,50684,1196
Quảng Ngãi,2014,19300,216,4048,97736,5301,4089,47228,287,50508,1212
Quảng Ngãi,2015,20387,218,4072,101170,5421,4215,48849,291,52321,1206
Quảng Ngãi,2016,20530,218,3821,97472,5442,3755,46918,296,50554,1687
Quảng Ngãi,2017,20412,217,3820,98288,5350,4209,47506,316,50782,1141
Quảng Ngãi,2018,20614,192,3778,101546,5024,4048,48842,284,52704,976
Quảng Ngãi,2019,19065,166,3529,100440,4787,3887,48228,253,52212,900
Quảng Ngãi,2020,20702,157,3609,101607,4915,3961,48833,286,52774,954
Quảng Ngãi,2021,20620,155,3691,108092,4806,3878,52154,287,55938,928
Quảng Ninh,2004,16009,154,4332,97489,5222,4807,47057,699,50432,415
Quảng Ninh,2005,15074,158,4144,91395,5207,4783,44248,688,47147,424
Quảng Ninh,2006,16678,161,4032,87251,5812,5168,44632,751,42619,644
Quảng Ninh,2007,13488,164,4065,86008,5076,4634,41600,684,44408,442
Quảng Ninh,2008,13325,164,4094,84585,5314,4783,41570,703,43015,531
Quảng Ninh,2009,12662,172,4008,86355,5517,4994,41496,778,44859,532
Quảng Ninh,2010,12825,173,4122,87675,5725,5143,42275,828,45400,582
Quảng Ninh,2011,15788,177,4298,88094,5401,4903,45246,0,42848,498
Quảng Ninh,2012,12506,180,4226,90404,5730,5181,43284,0,47120,549
Quảng Ninh,2013,13314,183,4314,96673,6166,5473,46200,895,50473,693
Quảng Ninh,2014,13516,183,4172,99592,5933,5320,47863,901,51729,613
Quảng Ninh,2015,13859,180,4225,106914,6003,5394,50863,858,56051,609
Quảng Ninh,2016,14385,180,4288,111362,6005,4463,53103,842,58259,1542
Quảng Ninh,2017,15094,180,4275,116355,5876,5275,55524,808,60831,601
Quảng Ninh,2018,14657,174,4419,125182,6634,5238,59914,808,65268,1396
Quảng Ninh,2019,16957,167,4354,128264,5765,5202,61192,807,67072,563
Quảng Ninh,2020,17956,161,4380,132424,5983,5435,63404,838,69020,548
Quảng Ninh,2021,18587,160,4416,135980,5798,5260,65143,794,70837,538
Quảng Trị,2004,9201,152,2671,71450,3426,2775,34247,100,37203,651
Quảng Trị,2005,9385,154,2613,66600,3439,2788,31890,134,34710,651
Quảng Trị,2006,10178,156,2542,61806,3556,2854,29719,166,32087,702
Quảng Trị,2007,10083,159,2521,59367,3658,2882,28431,181,30936,776
Quảng Trị,2008,10175,160,2499,56654,3601,2876,27424,147,29230,725
Quảng Trị,2009,10701,162,2257,56135,3716,2962,26358,136,29777,754
Quảng Trị,2010,11017,162,2508,56350,3733,2948,26774,147,29576,785
Quảng Trị,2011,10507,167,2520,56409,3661,2887,26358,152,30051,774
Quảng Trị,2012,11548,166,2489,56125,3726,2845,26110,156,30015,881
Quảng Trị,2013,11707,160,2534,57260,3772,2953,27351,177,29909,819
Quảng Trị,2014,11405,158,2537,56822,3768,2996,27641,189,29181,772
Quảng Trị,2015,11321,155,2568,57649,3849,3063,28139,173,29510,786
Quảng Trị,2016,11176,155,2535,56332,3782,2972,27343,180,28989,810
Quảng Trị,2017,11001,155,2533,57475,3779,3044,27834,190,29641,735
Quảng Trị,2018,7845,112,2245,46040,3200,2902,20757,181,25283,298
Quảng Trị,2019,9926,70,2502,56679,3411,2761,25971,172,30708,650
Quảng Trị,2020,11545,68,2519,61543,3527,2830,29391,197,32152,697
Quảng Trị,2021,11982,68,2577,65381,3555,2849,31338,212,34043,706
Sóc Trăng,2004,46862,254,5239,133212,6400,2687,63486,1626,69726,3713
Sóc Trăng,2005,42987,270,4928,123517,6523,2720,59363,1255,64154,3803
Sóc Trăng,2006,41092,280,4867,119952,6405,2670,57502,1687,62450,3735
Sóc Trăng,2007,40176,288,4839,118167,6533,2659,56661,1713,61506,3874
Sóc Trăng,2008,35318,291,4791,114639,6373,2687,50866,1677,63773,3686
Sóc Trăng,2009,36574,299,4722,118747,6260,2639,52688,1647,66059,3621
Sóc Trăng,2010,39179,297,4821,122345,6416,2709,59003,1846,63342,3707
Sóc Trăng,2011,40387,300,4857,123400,6519,2816,58781,1852,64619,3703
Sóc Trăng,2012,41449,300,5311,122755,6136,2714,58831,1858,63924,3422
Sóc Trăng,2013,44370,306,4937,123115,5913,3527,59571,369,63544,2386
Sóc Trăng,2014,45254,302,4664,122102,6713,2976,58716,2087,63386,3737
Sóc Trăng,2015,44932,297,4902,120625,6786,3049,58248,2087,62377,3737
Sóc Trăng,2016,44410,292,4286,116604,6688,3001,56301,2096,60303,3687
Sóc Trăng,2017,45374,281,4150,116770,6604,2948,56535,2110,60235,3656
Sóc Trăng,2018,48462,252,4169,76102,6428,2804,58755,2088,17347,3624
Sóc Trăng,2019,48840,222,3990,118405,5947,2659,57444,2066,60961,3288
Sóc Trăng,2020,49559,209,4064,119456,5910,2603,57831,2058,61625,3307
Sóc Trăng,2021,48505,204,4103,117542,5792,2585,57063,2063,60479,3207
Sơn La,2004,113332,192,6359,129328,7234,4674,57090,2990,72238,2560
Sơn La,2005,105571,219,6255,119676,6980,4455,53537,3280,66139,2525
Sơn La,2006,98769,231,6103,113270,6824,4507,49815,2861,63455,2317
Sơn La,2007,94923,245,6059,108181,6868,4538,48815,2963,59366,2330
Sơn La,2008,91841,253,6052,106853,7094,4797,48605,3060,58248,2297
Sơn La,2009,92132,265,6267,106098,6674,4450,48497,2555,57601,2224
Sơn La,2010,96371,268,6567,113228,7088,4651,51564,3275,61664,2437
Sơn La,2011,100599,273,6384,114799,7282,4744,54027,3559,60772,2538
Sơn La,2012,104201,280,6712,118539,7330,4744,56294,3843,62245,2586
Sơn La,2013,107691,282,6444,122814,7322,4712,58262,3811,64552,2610
Sơn La,2014,109373,286,6418,125403,7590,4848,59818,4083,65585,2742
Sơn La,2015,112016,289,6312,128642,7620,4785,61686,4157,66956,2835
Sơn La,2016,113800,289,6148,131506,7482,4643,63255,4131,68251,2839
Sơn La,2017,115713,286,6002,134531,7564,4755,64586,4321,69945,2809
Sơn La,2018,119839,192,5799,139806,7365,4619,67361,4225,72445,2746
Sơn La,2019,123606,97,5820,144225,7164,4483,69155,4129,75070,2681
Sơn La,2020,125704,97,5714,146782,7469,4699,70026,4478,76756,2770
Sơn La,2021,126914,97,5732,148948,7495,4739,70543,4551,78405,2756
TP.Hồ Chí Minh,2004,21563,444,11216,410168,14667,12156,191518,0,218650,2511
TP.Hồ Chí Minh,2005,20279,457,11255,408436,14266,11967,195511,0,212925,2299
TP.Hồ Chí Minh,2006,22566,458,11314,418257,14209,12037,198935,0,219322,2172
TP.Hồ Chí Minh,2007,17924,467,11428,424423,14629,12354,198440,0,225983,2275
TP.Hồ Chí Minh,2008,20459,467,11756,433101,14999,12571,207221,0,225880,2428
TP.Hồ Chí Minh,2009,27453,470,12377,472012,15768,13274,226764,0,245248,2494
TP.Hồ Chí Minh,2010,29414,468,13713,493255,15181,12838,235520,0,257735,2343
TP.Hồ Chí Minh,2011,27393,470,13334,504429,16811,14116,240134,0,264295,2695
TP.Hồ Chí Minh,2012,28815,474,13565,523403,17362,14362,249738,0,273665,3000
TP.Hồ Chí Minh,2013,29701,476,13875,547346,18552,15512,262422,283,284924,3040
TP.Hồ Chí Minh,2014,30555,482,14052,559445,19280,16211,268035,283,291410,3069
TP.Hồ Chí Minh,2015,31429,490,14550,584054,19874,16784,281300,306,302754,3090
TP.Hồ Chí Minh,2016,31371,493,14682,578784,20165,15254,278801,317,299983,4911
TP.Hồ Chí Minh,2017,31903,489,15134,602877,20577,17356,290044,351,312833,3221
TP.Hồ Chí Minh,2018,33719,494,16070,651609,21773,17838,313888,402,337721,3935
TP.Hồ Chí Minh,2019,33534,500,16515,655406,21558,18320,315530,454,339876,3238
TP.Hồ Chí Minh,2020,33516,507,16832,656660,22134,18788,315268,504,341392,3346
TP.Hồ Chí Minh,2021,33369,514,17276,679883,22202,18866,327490,548,352393,3336
Thanh Hóa,2004,67084,729,12964,324237,16122,12501,165221,2183,159016,3621
Thanh Hóa,2005,49327,729,11929,292822,15250,11498,147772,2076,145050,3752
Thanh Hóa,2006,52208,730,11003,264432,15461,12144,136305,1943,128127,3317
Thanh Hóa,2007,52823,729,10707,249890,14284,11399,122648,2409,127242,2885
Thanh Hóa,2008,50019,729,10402,242706,14549,11360,117606,2175,125100,3189
Thanh Hóa,2009,48002,727,10337,244172,13842,11260,125326,2159,118846,2582
Thanh Hóa,2010,50165,728,10307,246448,13809,11200,118547,2143,127901,2609
Thanh Hóa,2011,50852,728,10369,244639,14001,10761,116278,2212,128361,3240
Thanh Hóa,2012,49553,730,10381,243444,13855,11030,110028,2282,133416,2825
Thanh Hóa,2013,50490,731,10752,246775,13974,11405,112664,2178,134111,2569
Thanh Hóa,2014,52615,710,10119,247191,13314,10690,118521,2121,128670,2624
Thanh Hóa,2015,54097,709,10161,255979,13945,11365,122065,2214,133914,2580
Thanh Hóa,2016,56666,698,10093,263964,13608,10574,126007,2100,137957,3034
Thanh Hóa,2017,59340,677,10165,274948,13324,10784,130803,2018,144145,2540
Thanh Hóa,2018,64493,659,10422,300813,13360,10689,143061,1987,157752,2671
Thanh Hóa,2019,68435,641,10719,319366,13096,10594,151802,1956,167564,2502
Thanh Hóa,2020,71382,614,10972,333329,13308,10780,157840,2142,175489,2528
Thanh Hóa,2021,73056,601,11271,352408,13255,10715,167002,2134,185406,2540
Thái Bình,2004,0,293,4420,131555,6886,5994,68816,0,62739,892
Thái Bình,2005,0,294,4243,126696,6726,6142,61606,0,65090,584
Thái Bình,2006,0,294,4259,130415,6578,5760,68333,0,62082,818
Thái Bình,2007,0,294,4177,123153,6460,5870,58772,0,64381,590
Thái Bình,2008,0,293,4205,122632,6492,6057,56410,0,66222,435
Thái Bình,2009,0,293,4231,124697,6695,6220,58854,0,65843,475
Thái Bình,2010,0,293,4179,122513,7195,6307,60643,0,61870,888
Thái Bình,2011,0,293,4451,120164,7352,6473,57470,0,62694,879
Thái Bình,2012,0,293,4673,121739,7195,6307,58441,0,63298,888
Thái Bình,2013,0,295,4267,125264,7305,6429,60060,0,65204,876
Thái Bình,2014,0,295,4266,126072,7357,6520,60301,0,65771,837
Thái Bình,2015,0,295,4404,130130,7264,6447,62253,0,67877,817
Thái Bình,2016,0,295,4312,131301,7170,5744,62755,0,68546,1426
Thái Bình,2017,0,295,4556,133594,7035,6235,63861,0,69733,800
Thái Bình,2018,162,207,4369,143636,6688,5886,68174,0,75462,802
Thái Bình,2019,172,119,4350,142771,6276,5536,67850,0,74921,740
Thái Bình,2020,203,120,4339,145581,6038,5312,69409,0,76172,726
Thái Bình,2021,247,120,4348,149686,5947,5246,71317,0,78369,701
Thái Nguyên,2004,26276,226,3483,86972,5150,4775,42158,1018,44814,375
Thái Nguyên,2005,23911,225,3282,81679,4926,4615,39655,1031,42024,311
Thái Nguyên,2006,23916,227,3177,78056,5084,4768,38060,1096,39996,316
Thái Nguyên,2007,23640,226,3166,77744,4725,4391,37708,1022,40036,334
Thái Nguyên,2008,23947,226,2613,77249,4788,4404,37899,958,39350,384
Thái Nguyên,2009,24643,227,3257,79552,4686,4272,38195,961,41357,414
Thái Nguyên,2010,25608,226,3251,80902,4852,4347,41260,1019,39642,505
Thái Nguyên,2011,26127,225,3508,81440,4721,4278,38268,1579,43172,443
Thái Nguyên,2012,23055,225,3282,82347,5120,3472,37566,2139,44781,1648
Thái Nguyên,2013,29278,226,3439,86368,5325,4803,41684,1494,44684,522
Thái Nguyên,2014,30182,226,3514,87304,5414,4865,42133,1583,45171,549
Thái Nguyên,2015,32742,226,3602,93253,5452,4889,44896,1609,48357,563
Thái Nguyên,2016,35389,227,3521,98401,5508,4477,47319,1638,51082,1031
Thái Nguyên,2017,37989,228,3647,103584,5651,5070,49761,1732,53823,581
Thái Nguyên,2018,42133,224,3788,111912,5378,4919,53463,1682,58449,459
Thái Nguyên,2019,45359,219,3940,117312,5289,4768,56042,1632,61270,521
Thái Nguyên,2020,47608,214,4048,120785,5191,4683,57787,1583,62998,508
Thái Nguyên,2021,49949,213,4154,125218,4975,4484,59843,1573,65375,491
Thừa Thiên Huế,2004,6774,233,3986,128430,4728,3450,61558,77,66872,1278
Thừa Thiên Huế,2005,6391,235,3870,119795,4569,3334,57841,88,61954,1235
Thừa Thiên Huế,2006,10117,234,3724,111564,4575,2947,53906,68,57658,1628
Thừa Thiên Huế,2007,5490,235,3633,105923,4809,3483,51044,89,54879,1326
Thừa Thiên Huế,2008,1532,232,3572,101310,5299,4008,48697,69,52613,1291
Thừa Thiên Huế,2009,5379,228,3463,99967,4976,3673,47854,79,52113,1303
Thừa Thiên Huế,2010,5500,229,3544,98421,5104,3781,47274,72,51147,1323
Thừa Thiên Huế,2011,6838,226,3534,96722,5277,3810,46694,100,50028,1467
Thừa Thiên Huế,2012,5356,227,3483,93912,5254,3830,45168,127,48744,1424
Thừa Thiên Huế,2013,5375,225,3394,93009,5276,3861,44811,138,48198,1415
Thừa Thiên Huế,2014,5156,219,3254,91371,5179,3790,43922,119,47449,1389
Thừa Thiên Huế,2015,5021,216,3217,90492,5084,3748,43557,120,46935,1336
Thừa Thiên Huế,2016,5020,216,3128,86350,5055,3665,41513,123,44837,1390
Thừa Thiên Huế,2017,5141,215,3194,88935,5049,3818,42882,124,46053,1231
Thừa Thiên Huế,2018,5315,208,3259,93068,4902,3794,44773,109,48295,1108
Thừa Thiên Huế,2019,5533,200,3324,95604,4844,3769,45953,94,49651,1075
Thừa Thiên Huế,2020,5601,195,3365,98093,4756,3722,47105,102,50988,1034
Thừa Thiên Huế,2021,5806,195,3487,106121,4881,3829,51013,107,55108,1052
Tiền Giang,2004,0,233,4680,140372,5369,3883,67271,0,73101,1486
Tiền Giang,2005,0,230,4513,135882,5252,3802,65539,0,70343,1450
Tiền Giang,2006,0,231,4455,133950,5024,3538,64948,0,69002,1486
Tiền Giang,2007,0,230,4341,132575,5144,3696,64487,0,68088,1448
Tiền Giang,2008,0,229,4250,130289,5397,3854,63399,0,66890,1543
Tiền Giang,2009,0,229,4342,138434,5570,3843,67101,0,71333,1727
Tiền Giang,2010,0,226,4335,140518,5806,3984,67648,0,72870,1822
Tiền Giang,2011,0,228,4504,139715,5959,4120,67595,0,72120,1839
Tiền Giang,2012,0,227,4411,140475,6050,4162,67984,0,72491,1888
Tiền Giang,2013,0,228,4439,141460,6169,4175,68496,0,72964,1994
Tiền Giang,2014,0,226,4427,139186,6287,4281,67173,0,72013,2006
Tiền Giang,2015,0,226,4384,140566,6251,4263,67843,0,72723,1988
Tiền Giang,2016,0,224,4569,134113,6277,4185,64621,0,69492,2092
Tiền Giang,2017,0,224,4163,133832,6153,4217,64762,0,69070,1936
Tiền Giang,2018,128,205,4177,96797,6222,4136,66770,0,30027,2086
Tiền Giang,2019,170,186,4092,135764,5938,4054,65667,0,70097,1884
Tiền Giang,2020,186,173,4043,133145,5868,3969,64585,0,68560,1899
Tiền Giang,2021,190,171,4095,138021,5693,3819,66918,0,71103,1874
Trà Vinh,2004,28119,220,3393,85064,4569,1982,40156,1182,44908,2587
Trà Vinh,2005,26019,216,3194,79745,4495,1976,38055,1203,41690,2519
Trà Vinh,2006,25943,217,3156,78826,4376,1955,37317,1091,41509,2421
Trà Vinh,2007,25588,215,3153,77917,4485,2013,37726,1196,40191,2472
Trà Vinh,2008,25200,213,3197,76385,4417,1996,36616,1136,39769,2421
Trà Vinh,2009,25868,214,3274,79003,4560,1988,38123,1145,40880,2572
Trà Vinh,2010,27192,215,3395,81608,4732,2138,39343,1234,42265,2594
Trà Vinh,2011,27048,215,3368,81169,4704,2151,39062,1255,42107,2553
Trà Vinh,2012,27435,214,3363,81229,4905,2134,39287,1276,41942,2771
Trà Vinh,2013,27751,215,3401,81784,4945,2183,39397,1284,42387,2762
Trà Vinh,2014,28386,214,3360,81792,5011,2258,39589,1331,42203,2753
Trà Vinh,2015,29023,212,3387,82859,5070,2355,40037,1347,42822,2715
Trà Vinh,2016,29639,213,3330,82087,5079,2304,39659,1357,42428,2775
Trà Vinh,2017,30658,212,3319,83504,5067,2368,40251,1366,43253,2699
Trà Vinh,2018,32519,191,3263,82935,5105,2316,42084,1342,40851,2789
Trà Vinh,2019,33791,170,3153,87752,4873,2265,42229,1318,45523,2608
Trà Vinh,2020,34587,163,3130,88705,4762,2196,42521,1290,46184,2566
Trà Vinh,2021,34581,163,3112,89318,4611,2145,42817,1287,46501,2466
Tuyên Quang,2004,41494,169,3443,67583,4349,3700,32535,1588,35048,649
Tuyên Quang,2005,37925,168,3374,62432,4277,3642,30069,1625,32363,635
Tuyên Quang,2006,35068,164,3169,57834,4010,3391,28114,1501,29720,619
Tuyên Quang,2007,33818,160,3074,57084,3966,3324,27576,1566,29508,642
Tuyên Quang,2008,34191,154,3085,56094,3817,3199,27087,1276,29007,618
Tuyên Quang,2009,33828,156,3383,56875,3851,3223,27362,1474,29513,628
Tuyên Quang,2010,35339,153,3154,58108,3858,3189,27497,1605,30611,669
Tuyên Quang,2011,36022,151,3142,58652,3319,2714,25818,1616,32834,605
Tuyên Quang,2012,36768,152,3179,59527,3909,3104,29201,1627,30326,805
Tuyên Quang,2013,38168,150,3138,61756,3923,3053,29415,1593,32341,870
Tuyên Quang,2014,38063,151,3106,62883,3942,3097,29600,1649,33283,845
Tuyên Quang,2015,41732,148,3101,66072,3998,3172,32021,1739,34051,826
Tuyên Quang,2016,44552,144,3155,69837,4046,2805,33581,1735,36256,1241
Tuyên Quang,2017,46831,144,3112,72780,4030,3221,35025,1744,37755,809
Tuyên Quang,2018,50815,142,3201,78798,3580,3099,37547,1666,41251,481
Tuyên Quang,2019,52424,139,3181,81251,3685,2977,37951,1589,43300,708
Tuyên Quang,2020,54746,136,3185,83249,3897,3142,39209,1747,44040,755
Tuyên Quang,2021,56049,132,3102,84784,3850,3079,40337,1751,44447,771
Tây Ninh,2004,1716,300,4546,94940,4777,3506,45733,0,49207,1271
Tây Ninh,2005,1437,293,3529,89232,4660,3407,43219,0,46013,1253
Tây Ninh,2006,1341,293,3439,87609,4455,3211,42248,0,45361,1244
Tây Ninh,2007,1333,291,3307,86013,4401,3267,41666,0,44347,1134
Tây Ninh,2008,1325,290,3275,84582,4533,3337,40685,0,43897,1196
Tây Ninh,2009,1371,286,3378,87391,4437,3296,42030,0,45361,1141
Tây Ninh,2010,1494,283,3300,89218,4542,3325,42867,0,46351,1217
Tây Ninh,2011,1602,271,3587,89428,4564,3348,42939,0,46489,1216
Tây Ninh,2012,1706,270,3619,90106,4819,3307,43229,0,46877,1512
Tây Ninh,2013,1825,265,4135,92932,4551,3312,44613,0,48319,1239
Tây Ninh,2014,1917,261,3896,94558,4694,3418,45626,0,48932,1276
Tây Ninh,2015,1970,262,3788,96938,4781,3471,46599,0,50339,1310
Tây Ninh,2016,2018,260,3308,94830,4831,3471,45681,0,49149,1360
Tây Ninh,2017,2086,261,3288,96060,4816,3501,46186,0,49874,1315
Tây Ninh,2018,2325,240,3243,99942,4836,3363,48139,0,51803,1473
Tây Ninh,2019,2464,220,3134,98693,4472,3225,47436,0,51257,1247
Tây Ninh,2020,2651,207,3147,99020,4503,3265,47627,0,51393,1238
Tây Ninh,2021,2709,196,3122,100258,4353,3174,48217,0,52041,1179
Vĩnh Long,2004,1648,248,3301,82130,4166,2385,39654,0,42476,1781
Vĩnh Long,2005,2009,247,3219,78782,3749,2131,37705,0,41077,1618
Vĩnh Long,2006,1838,247,3197,77625,3808,2170,37784,0,39841,1638
Vĩnh Long,2007,1933,246,3152,76844,3904,2225,37426,0,39418,1679
Vĩnh Long,2008,1934,244,3095,75113,4057,2303,35447,0,39666,1754
Vĩnh Long,2009,1948,244,3074,79456,4085,2353,38562,0,40894,1732
Vĩnh Long,2010,1949,241,3064,80233,4172,2361,38757,0,41476,1811
Vĩnh Long,2011,1859,239,2989,79035,3999,2303,37990,0,41045,1696
Vĩnh Long,2012,1678,229,2969,78884,4326,2400,37665,0,41219,1926
Vĩnh Long,2013,1914,214,2971,79584,4333,2436,38641,0,40943,1897
Vĩnh Long,2014,2036,207,2929,78880,4165,2455,37972,0,40908,1710
Vĩnh Long,2015,1995,206,3010,80884,4188,2482,39076,0,41808,1706
Vĩnh Long,2016,2081,199,2865,78483,4192,2471,38026,0,40457,1721
Vĩnh Long,2017,2186,197,3138,79590,4131,2457,38512,65,41078,1674
Vĩnh Long,2018,2507,185,2782,143701,4196,2410,40035,72,103666,1786
Vĩnh Long,2019,2664,173,2751,83330,3979,2363,40252,80,43078,1616
Vĩnh Long,2020,2716,165,2709,81235,3905,2327,39287,83,41948,1578
Vĩnh Long,2021,2846,160,2709,84022,3785,2272,40637,86,43385,1513
Vĩnh Phúc,2004,4869,193,3773,98420,4565,3617,48341,0,50079,948
Vĩnh Phúc,2005,4424,199,3610,91684,4451,3828,43878,0,47806,623
Vĩnh Phúc,2006,3848,204,3524,88231,4293,3688,43220,0,45011,605
Vĩnh Phúc,2007,4064,205,3447,85993,4464,3764,41512,0,44481,700
Vĩnh Phúc,2008,4045,173,2909,70906,3705,3056,34509,0,36397,649
Vĩnh Phúc,2009,4014,173,2886,72599,3807,3219,35035,0,37564,588
Vĩnh Phúc,2010,3903,174,2936,75452,3903,3329,35504,0,39948,574
Vĩnh Phúc,2011,3996,174,2927,77981,3826,3306,37649,0,40332,520
Vĩnh Phúc,2012,4233,173,2943,81949,4088,3389,38854,0,43095,699
Vĩnh Phúc,2013,4393,173,3042,87769,4311,3725,41828,88,45941,586
Vĩnh Phúc,2014,4627,173,3114,91919,4225,3641,43746,89,48173,584
Vĩnh Phúc,2015,4957,174,3030,97061,4469,3887,45870,104,51191,582
Vĩnh Phúc,2016,5462,176,3123,101268,4362,3402,47502,96,53766,960
Vĩnh Phúc,2017,5955,176,3237,105801,4633,4046,49298,109,56503,587
Vĩnh Phúc,2018,7000,162,3420,116240,4169,4010,53985,120,62255,159
Vĩnh Phúc,2019,7674,149,3572,121686,4539,3975,56521,131,65165,564
Vĩnh Phúc,2020,8064,145,3687,125578,4785,4203,57943,165,67635,582
Vĩnh Phúc,2021,8506,145,3767,129510,4785,4197,60111,174,69399,588
Yên Bái,2004,49042,165,3439,76624,4195,3379,36356,970,40268,816
Yên Bái,2005,45438,174,3341,70852,4029,3202,33886,970,36966,827
Yên Bái,2006,42017,177,3040,65951,3843,3049,31724,940,34227,794
Yên Bái,2007,40250,176,2898,63907,3810,3036,30722,924,33185,774
Yên Bái,2008,39899,182,2918,63566,3745,2901,30500,875,33066,844
Yên Bái,2009,39856,170,2715,64579,3812,3005,30776,929,33803,807
Yên Bái,2010,41072,169,2882,66411,3998,2978,31667,1032,34744,1020
Yên Bái,2011,42230,169,2957,67714,4199,3101,32248,1086,35466,1098
Yên Bái,2012,43370,169,2986,69006,4273,3112,32997,1139,36009,1161
Yên Bái,2013,44462,169,2994,70843,4238,3089,34163,1199,36680,1149
Yên Bái,2014,45233,168,2990,71495,4204,3066,34549,1214,36946,1138
Yên Bái,2015,46560,165,2972,73426,4149,3000,35401,1222,38025,1149
Yên Bái,2016,48227,52,2785,75540,4092,2932,36578,1199,38962,1160
Yên Bái,2017,49866,52,2739,77644,3984,2862,37443,1183,40201,1122
Yên Bái,2018,52994,52,2695,81471,3904,2796,39077,1162,42394,1108
Yên Bái,2019,55659,53,2742,84389,3790,2729,40420,1141,43969,1061
Yên Bái,2020,57259,56,2786,86245,3743,2691,41303,1135,44942,1052
Yên Bái,2021,58700,57,2816,88345,3680,2649,42123,1114,46222,1031
Điện Biên,2004,55574,123,3310,62162,3731,2362,26187,1372,35975,1369
Điện Biên,2005,52231,134,3106,58546,3747,2417,25088,1309,33458,1330
Điện Biên,2006,50147,138,3317,57060,3977,2536,25376,1309,31684,1441
Điện Biên,2007,48685,146,3073,54768,3650,2240,23677,1227,31091,1410
Điện Biên,2008,47239,156,3159,54486,3892,2336,25041,1373,29445,1556
Điện Biên,2009,49521,168,3284,55751,4056,2465,26071,1536,29680,1591
Điện Biên,2010,51467,170,3368,58075,4453,2698,27262,1825,30813,1755
Điện Biên,2011,53307,173,3439,60175,4414,2579,28354,2128,31821,1835
Điện Biên,2012,54589,172,3455,61665,5174,2982,29279,2430,32386,2192
Điện Biên,2013,55653,173,3217,63281,4805,2636,30112,2170,33169,2169
Điện Biên,2014,55753,175,3176,63740,4699,2721,30372,2230,33368,1978
Điện Biên,2015,56268,175,3153,64595,4729,2725,30999,2246,33596,2004
Điện Biên,2016,56774,176,3140,65510,4535,2610,31297,2273,34213,1925
Điện Biên,2017,57162,176,3062,66300,4408,2511,31804,2305,34496,1897
Điện Biên,2018,59106,174,2895,69005,4393,2448,33197,2296,35808,1945
Điện Biên,2019,60498,171,2872,70486,4202,2385,33952,2287,36534,1817
Điện Biên,2020,62414,148,2856,73013,4184,2362,35230,2338,37783,1822
Điện Biên,2021,64731,140,2925,75750,4101,2295,36624,2325,39126,1806
Đà Nẵng,2004,0,95,2050,67743,2839,2603,32514,0,35229,236
Đà Nẵng,2005,0,96,1958,63871,2799,2549,31129,0,32742,250
Đà Nẵng,2006,1147,98,1911,61210,2740,2495,29283,0,31927,245
Đà Nẵng,2007,0,100,1895,59319,2809,2542,28562,0,30757,267
Đà Nẵng,2008,0,100,1846,58991,2815,2533,28066,0,30925,282
Đà Nẵng,2009,0,99,2196,63186,2870,2577,30460,0,32726,293
Đà Nẵng,2010,0,99,1977,66067,2961,2630,31753,0,34314,331
Đà Nẵng,2011,0,100,2066,69388,2978,2683,33357,0,36031,295
Đà Nẵng,2012,0,100,2117,72985,3074,2734,35031,0,37954,340
Đà Nẵng,2013,0,100,2209,77578,3112,2629,37160,0,40418,483
Đà Nẵng,2014,0,99,2284,80548,3493,3182,38792,0,41756,311
Đà Nẵng,2015,0,99,2385,84401,3560,3235,40536,0,43865,325
Đà Nẵng,2016,0,99,2457,82851,3613,2865,39823,0,43028,748
Đà Nẵng,2017,0,100,2532,88513,3813,3474,42188,0,46325,339
Đà Nẵng,2018,204,100,2722,95628,3840,3598,45693,0,49935,242
Đà Nẵng,2019,222,99,2793,98964,4058,3721,47163,0,51801,337
Đà Nẵng,2020,226,99,2892,101275,3947,3633,48453,0,52822,314
Đà Nẵng,2021,249,99,3072,109317,4130,3797,52348,0,56969,333
Đắk Lắk,2004,90705,352,7988,235457,9469,7854,111639,1099,123818,1615
Đắk Lắk,2005,88229,360,7787,222079,9108,7835,106124,1019,115955,1273
Đắk Lắk,2006,85593,379,7592,212415,9185,7806,101718,1035,110697,1379
Đắk Lắk,2007,80283,382,7435,201291,9357,8098,96461,1043,104830,1259
Đắk Lắk,2008,78212,396,7346,192037,9610,8121,91725,1061,100312,1489
Đắk Lắk,2009,75963,397,7201,189570,9478,7932,90839,1149,98731,1546
Đắk Lắk,2010,73079,410,7079,182481,9816,8510,87662,1176,94819,1306
Đắk Lắk,2011,71776,417,7191,179102,10049,8441,86157,1216,92945,1608
Đắk Lắk,2012,69677,422,7060,173130,10462,8730,77421,1256,95709,1732
Đắk Lắk,2013,70592,422,7131,174997,10550,8501,79050,1378,95947,2049
Đắk Lắk,2014,71227,422,7580,175576,10641,8917,84099,1353,91477,1724
Đắk Lắk,2015,70783,424,7580,179182,10875,9073,86093,1405,93089,1802
Đắk Lắk,2016,70722,423,7328,176027,10993,7952,84506,1443,91521,3041
Đắk Lắk,2017,71781,425,7175,180461,10985,9186,86982,1433,93479,1799
Đắk Lắk,2018,74325,416,7091,187666,10723,8866,90834,1374,96832,1857
Đắk Lắk,2019,76655,408,6986,189348,10175,8546,91313,1314,98035,1629
Đắk Lắk,2020,78663,398,6905,190004,9983,8350,91324,1276,98680,1633
Đắk Lắk,2021,80733,388,6937,198943,9796,8173,95758,1250,103185,1623
Đắk Nông,2004,23241,85,2052,59034,2226,1774,27441,174,31593,452
Đắk Nông,2005,16320,97,2136,60129,2582,2001,27359,188,32770,581
Đắk Nông,2006,16181,100,2191,54302,2308,1889,26225,190,28077,419
Đắk Nông,2007,25309,111,2285,58273,2528,2013,26866,241,31407,515
Đắk Nông,2008,24288,121,2272,58336,2657,2073,28336,198,30000,584
Đắk Nông,2009,27921,130,2235,58642,2760,2193,27922,299,30720,567
Đắk Nông,2010,24403,130,2208,58791,2973,2418,28247,322,30544,555
Đắk Nông,2011,24573,136,2472,59553,3033,2442,28476,330,31077,591
Đắk Nông,2012,24839,143,2318,60577,3104,2398,29073,338,31504,706
Đắk Nông,2013,25087,145,2378,62519,3312,2687,29793,368,32726,625
Đắk Nông,2014,25124,144,2476,64478,3376,2732,30701,377,33777,644
Đắk Nông,2015,25039,142,2391,66700,3337,2702,31749,376,34951,635
Đắk Nông,2016,24847,142,2405,66829,3380,2746,31736,397,35093,634
Đắk Nông,2017,24693,146,2402,68666,3339,2711,32747,381,35919,628
Đắk Nông,2018,24838,139,2377,71199,3387,2600,34114,364,37085,787
Đắk Nông,2019,23921,132,2251,68641,3049,2490,32862,348,35779,559
Đắk Nông,2020,26328,122,2369,71982,3253,2633,34406,370,37576,620
Đắk Nông,2021,27219,122,2402,75067,3170,2578,36020,374,39047,592
Đồng Nai,2004,10759,295,7319,217385,8287,7130,104521,0,112864,1157
Đồng Nai,2005,10759,296,7112,206979,8472,7124,104521,0,102458,1348
Đồng Nai,2006,11251,296,6930,202426,8458,7383,104011,53,98415,1075
Đồng Nai,2007,10852,297,6837,199720,8385,7288,95818,57,103902,1097
Đồng Nai,2008,10240,299,6722,198037,8413,7351,93079,63,104958,1062
Đồng Nai,2009,10820,300,6741,205751,8379,7327,97985,546,107766,1052
Đồng Nai,2010,10534,298,6820,210681,8800,7630,101125,106,109556,1170
Đồng Nai,2011,12379,297,6805,211956,8802,7634,101791,98,110165,1168
Đồng Nai,2012,13499,299,6939,215997,8923,7509,103643,91,112354,1414
Đồng Nai,2013,13927,302,7279,227077,9281,8029,108877,117,118200,1252
Đồng Nai,2014,14589,300,7511,235512,9528,8252,112839,136,122673,1276
Đồng Nai,2015,15701,300,7401,249059,9713,8384,119325,142,129734,1329
Đồng Nai,2016,16017,301,7526,251825,9911,8400,120372,149,131453,1511
Đồng Nai,2017,16598,303,7659,263182,10033,8724,126054,152,137128,1309
Đồng Nai,2018,18968,300,7825,279858,10493,8832,134454,182,145404,1661
Đồng Nai,2019,20314,297,8030,290582,10263,8939,139512,213,151070,1324
Đồng Nai,2020,20797,290,8175,295188,10186,8883,141741,217,153447,1303
Đồng Nai,2021,21316,290,8343,305422,10333,9042,147224,222,158198,1291
Đồng Tháp,2004,0,306,5625,149595,7006,3807,71728,0,77867,3199
Đồng Tháp,2005,0,308,5579,141392,6986,3753,67692,0,73700,3233
Đồng Tháp,2006,0,313,5430,139041,6868,2671,67050,0,71991,4197
Đồng Tháp,2007,0,316,5354,138509,6747,3661,66986,0,71523,3086
Đồng Tháp,2008,0,316,5368,135420,6581,3581,64943,0,70477,3000
Đồng Tháp,2009,0,317,5456,139861,6878,3581,67142,0,72719,3297
Đồng Tháp,2010,0,321,5529,142328,7045,3747,68794,0,73534,3298
Đồng Tháp,2011,0,321,5527,142871,6951,3690,68655,0,74216,3261
Đồng Tháp,2012,0,321,5547,144306,7168,3846,69305,0,75001,3322
Đồng Tháp,2013,0,319,5841,146476,7293,3884,70378,0,76098,3409
Đồng Tháp,2014,0,319,5618,146945,7319,3913,70873,0,76072,3406
Đồng Tháp,2015,0,320,5526,148999,7244,3864,71952,0,77047,3380
Đồng Tháp,2016,0,317,5443,142435,7242,3686,68503,0,73932,3556
Đồng Tháp,2017,0,313,5334,140537,7170,3797,67708,0,72829,3373
Đồng Tháp,2018,81,298,5227,191533,7245,3668,69538,0,121995,3577
Đồng Tháp,2019,105,283,5080,140191,6762,3539,67754,0,72437,3223
Đồng Tháp,2020,132,271,5029,137532,6674,3509,66508,0,71024,3165
Đồng Tháp,2021,119,258,4941,137051,6289,3346,66598,0,70453,2943
